zcta5,total_25yo,edu_gr9,edu_gr12_nd,edu_hs,edu_col_nd,edu_asc,edu_ba,edu_grad,edu_min_hs,edu_min_ba
06390,41,0,0,28,9,0,4,0,41,4
10001,21203,741,1189,1802,1771,661,8911,6128,19273,15039
10002,60952,9858,8443,11085,5998,2347,16087,7134,42651,23221
10003,37093,1001,573,1984,2222,912,16265,14136,35519,30401
10004,3586,16,16,31,124,11,1588,1800,3554,3388
10005,6842,64,104,342,195,65,3870,2202,6674,6072
10006,2937,0,0,142,230,89,1168,1308,2937,2476
10007,5558,51,176,286,258,44,2851,1892,5331,4743
10009,46815,3274,2929,5085,4455,1917,17467,11688,40612,29155
10010,23887,237,430,1432,2051,526,10152,9059,23220,19211
10011,42006,812,999,2686,3242,1141,16470,16656,40195,33126
10012,16809,401,275,848,1058,291,8292,5644,16133,13936
10013,22108,1308,1467,1983,1365,392,9554,6039,19333,15593
10014,25527,105,183,1281,2028,287,12251,9392,25239,21643
10016,43500,514,952,2309,3142,960,18102,17521,42034,35623
10017,12829,273,211,473,806,50,5396,5620,12345,11016
10018,7451,259,359,525,375,234,3053,2646,6833,5699
10019,37804,614,735,3204,2450,1771,15840,13190,36455,29030
10020,0,0,0,0,0,0,0,0,0,0
10021,32595,220,552,2172,2772,1027,12403,13449,31823,25852
10022,28679,359,225,1893,1629,635,10369,13569,28095,23938
10023,52617,403,831,3213,3402,994,19693,24081,51383,43774
10024,49806,1242,726,2566,3114,919,18061,23178,47838,41239
10025,72928,3385,3354,7340,7815,1940,20984,28110,66189,49094
10026,27690,1381,1772,5908,3721,1129,7474,6305,24537,13779
10027,42580,2294,3131,8304,5335,1859,10778,10879,37155,21657
10028,37597,458,109,2319,2962,986,12981,17782,37030,30763
10029,55086,7818,5125,13643,7665,2558,10469,7808,42143,18277
10030,23150,2434,2589,4942,3756,1294,4321,3814,18127,8135
10031,47467,5827,4502,8403,7999,1665,11351,7720,37138,19071
10032,46094,7844,4071,8114,6677,2358,10432,6598,34179,17030
10033,43653,6015,4116,7773,5910,2844,9377,7618,33522,16995
10034,30717,3757,2795,5573,4774,1449,6831,5538,24165,12369
10035,27304,3172,3619,7415,3595,1419,4769,3315,20513,8084
10036,26043,865,1083,2551,2851,1207,10341,7145,24095,17486
10037,14386,876,990,3350,1962,908,3638,2662,12520,6300
10038,16829,1666,1309,1734,1203,687,6525,3705,13854,10230
10039,20839,2099,1687,5329,4168,1437,3649,2470,17053,6119
10040,32333,4218,3277,6893,4433,1483,6687,5342,24838,12029
10044,9072,364,352,1182,513,393,2176,4092,8356,6268
10065,24164,304,101,1199,1480,376,9797,10907,23759,20704
10069,4683,0,0,475,32,111,1752,2313,4683,4065
10075,18721,86,242,1626,992,569,6250,8956,18393,15206
10103,0,0,0,0,0,0,0,0,0,0
10110,0,0,0,0,0,0,0,0,0,0
10111,0,0,0,0,0,0,0,0,0,0
10112,0,0,0,0,0,0,0,0,0,0
10115,0,0,0,0,0,0,0,0,0,0
10119,0,0,0,0,0,0,0,0,0,0
10128,45485,938,1047,3831,2486,2235,15493,19455,43500,34948
10152,0,0,0,0,0,0,0,0,0,0
10153,0,0,0,0,0,0,0,0,0,0
10154,0,0,0,0,0,0,0,0,0,0
10162,1286,0,77,339,0,19,454,397,1209,851
10165,0,0,0,0,0,0,0,0,0,0
10167,0,0,0,0,0,0,0,0,0,0
10168,0,0,0,0,0,0,0,0,0,0
10169,0,0,0,0,0,0,0,0,0,0
10170,0,0,0,0,0,0,0,0,0,0
10171,0,0,0,0,0,0,0,0,0,0
10172,0,0,0,0,0,0,0,0,0,0
10173,0,0,0,0,0,0,0,0,0,0
10174,0,0,0,0,0,0,0,0,0,0
10177,0,0,0,0,0,0,0,0,0,0
10199,0,0,0,0,0,0,0,0,0,0
10271,0,0,0,0,0,0,0,0,0,0
10278,0,0,0,0,0,0,0,0,0,0
10279,161,0,0,0,51,18,47,45,161,92
10280,7261,95,17,369,460,56,2996,3268,7149,6264
10282,4480,23,13,256,180,419,1403,2186,4444,3589
10301,28291,1659,2216,6728,4824,1619,5895,5350,24416,11245
10302,12259,826,833,4457,1639,901,2282,1321,10600,3603
10303,17857,1662,1790,5496,2641,1363,3261,1644,14405,4905
10304,30873,1882,3160,9090,5397,1807,6180,3357,25831,9537
10305,31477,2618,2145,8924,4576,2975,6239,4000,26714,10239
10306,39837,2321,2250,13290,6696,2436,7520,5324,35266,12844
10307,10101,284,497,2351,1899,1148,2008,1914,9320,3922
10308,22074,500,568,6851,3249,1969,5102,3835,21006,8937
10309,24109,545,1364,7003,4358,1872,5119,3848,22200,8967
10310,17364,944,1250,5075,3121,1341,3110,2523,15170,5633
10311,0,0,0,0,0,0,0,0,0,0
10312,43865,1199,1964,13440,6814,3273,10340,6835,40702,17175
10314,66532,3529,3025,19704,10796,4710,15792,8976,59978,24768
10451,33532,4093,5197,8939,5990,2693,4591,2029,24242,6620
10452,49113,7927,7074,14284,8111,4664,4937,2116,34112,7053
10453,50570,8674,7700,14578,8471,3609,5756,1782,34196,7538
10454,25781,5189,4954,7296,3966,1385,2323,668,15638,2991
10455,27345,4211,4555,7754,4634,2279,2844,1068,18579,3912
10456,55052,9112,9252,16305,8825,4557,5140,1861,36688,7001
10457,47967,7312,7339,14163,8465,3436,4929,2323,33316,7252
10458,49281,9078,6642,13618,9552,3288,4788,2315,33561,7103
10459,32618,5644,4680,9233,5434,3035,3330,1262,22294,4592
10460,38400,5738,5614,11950,6541,3082,4286,1189,27048,5475
10461,36027,3472,3360,10083,5607,3758,6066,3681,29195,9747
10462,51876,4231,4447,15465,8278,5039,9543,4873,43198,14416
10463,50071,3887,4534,9617,7409,3338,10781,10505,41650,21286
10464,3468,29,135,711,284,423,878,1008,3304,1886
10465,31189,2272,2171,8392,6802,2419,5634,3499,26746,9133
10466,48817,3544,5969,15327,8018,4120,7433,4406,39304,11839
10467,66270,8117,8741,19041,10968,5120,8709,5574,49412,14283
10468,52353,7373,7432,16033,9759,3876,5028,2852,37548,7880
10469,49816,3662,5032,13811,8874,4396,8721,5320,41122,14041
10470,11579,593,1044,3159,1687,638,3237,1221,9942,4458
10471,16424,581,821,2304,2278,814,4265,5361,15022,9626
10472,41079,7599,5512,12939,6321,2880,4225,1603,27968,5828
10473,40539,5020,4967,9774,7947,3774,5618,3439,30552,9057
10474,6787,761,906,2455,1263,376,597,429,5120,1026
10475,31179,1286,3324,9079,6286,3190,4854,3160,26569,8014
10501,1045,0,18,88,30,123,393,393,1027,786
10502,3896,1,101,509,180,131,1208,1766,3794,2974
10503,94,0,0,0,0,7,16,71,94,87
10504,5404,25,96,441,218,287,2146,2191,5283,4337
10505,808,9,30,198,101,0,241,229,769,470
10506,3996,40,6,218,238,78,1491,1925,3950,3416
10507,4422,647,405,769,640,169,877,915,3370,1792
10509,14418,586,692,3426,2439,1086,3842,2347,13140,6189
10510,7403,208,106,676,615,443,2450,2905,7089,5355
10511,1620,22,34,399,277,139,512,237,1564,749
10512,17949,502,791,4946,2671,1413,4306,3320,16656,7626
10514,8157,82,3,286,521,284,2560,4421,8072,6981
10516,4180,46,99,619,524,339,1288,1265,4035,2553
10517,289,38,4,70,32,6,103,36,247,139
10518,603,23,0,28,82,12,319,139,580,458
10519,43,0,0,0,0,0,43,0,43,43
10520,9061,220,248,1310,1251,652,2700,2680,8593,5380
10522,7427,270,114,691,1010,312,1892,3138,7043,5030
10523,6499,375,208,1339,1110,435,1957,1075,5916,3032
10524,3226,97,28,708,536,170,671,1016,3101,1687
10526,1306,7,17,77,136,43,433,593,1282,1026
10527,450,0,4,45,52,5,134,210,446,344
10528,8949,40,262,1384,1339,902,3037,1985,8647,5022
10530,11096,170,448,1312,1264,604,3846,3452,10478,7298
10532,3625,185,142,704,444,298,863,989,3298,1852
10533,4737,0,81,276,255,344,1391,2390,4656,3781
10535,201,0,6,0,5,0,44,146,195,190
10536,7430,121,71,707,568,348,2875,2740,7238,5615
10537,1971,80,41,354,275,168,547,506,1850,1053
10538,11648,147,64,848,676,469,4171,5273,11437,9444
10540,9,0,0,0,9,0,0,0,9,0
10541,17943,407,646,4346,3107,1945,4297,3195,16890,7492
10542,0,0,0,0,0,0,0,0,0,0
10543,14835,923,837,2532,1752,665,4485,3641,13075,8126
10545,190,6,20,27,0,12,11,114,164,125
10546,673,0,0,27,24,32,258,332,673,590
10547,5404,150,226,1123,995,407,1321,1182,5028,2503
10548,2866,73,139,628,520,230,801,475,2654,1276
10549,11295,894,390,1615,893,575,2872,4056,10011,6928
10550,28436,1812,3329,8371,6359,2118,3536,2911,23295,6447
10552,16615,1028,647,2743,2609,1288,4538,3762,14940,8300
10553,7901,601,875,1056,1221,871,2164,1113,6425,3277
10560,3684,41,66,491,469,198,1461,958,3577,2419
10562,24882,2003,1425,4763,3847,1591,5137,6116,21454,11253
10566,18772,1139,1318,4341,3395,1620,4062,2897,16315,6959
10567,13786,281,423,2839,2214,1010,3269,3750,13082,7019
10570,8425,241,116,835,703,261,3010,3259,8068,6269
10573,28188,3050,1823,6017,3624,1894,6637,5143,23315,11780
10576,3563,5,26,359,189,186,1582,1216,3532,2798
10577,2027,18,51,109,136,108,1019,586,1958,1605
10578,1132,0,0,153,119,7,666,187,1132,853
10579,5813,153,98,1275,1303,454,1378,1152,5562,2530
10580,11390,46,127,678,691,489,4119,5240,11217,9359
10583,27497,231,312,2129,1632,1289,8556,13348,26954,21904
10588,2217,76,132,342,287,149,714,517,2009,1231
10589,5836,134,66,727,855,471,1544,2039,5636,3583
10590,5112,61,8,640,560,313,1924,1606,5043,3530
10591,17269,1318,1188,2371,2229,830,4391,4942,14763,9333
10594,3843,134,99,688,533,413,1086,890,3610,1976
10595,5191,210,352,1233,731,379,1392,894,4629,2286
10596,639,10,45,252,83,42,132,75,584,207
10597,431,21,0,25,8,23,97,257,410,354
10598,20706,688,489,3240,2700,1831,6484,5274,19529,11758
10601,8603,440,453,1035,1081,672,2485,2437,7710,4922
10603,13946,849,739,2927,1684,989,3538,3220,12358,6758
10604,7686,335,512,1628,1007,469,1888,1847,6839,3735
10605,14678,409,765,1877,1253,910,4064,5400,13504,9464
10606,11632,954,689,2430,1647,708,2460,2744,9989,5204
10607,4953,356,263,1040,406,495,1156,1237,4334,2393
10701,46168,4825,4832,11645,7487,4042,7793,5544,36511,13337
10703,16313,1254,1775,4304,2737,1505,2489,2249,13284,4738
10704,22999,1361,1630,6471,3641,1328,4643,3925,20008,8568
10705,26658,3266,2620,6828,4061,2038,4249,3596,20772,7845
10706,6493,182,100,667,656,248,1888,2752,6211,4640
10707,7652,294,138,840,1085,300,2432,2563,7220,4995
10708,15734,163,425,1733,2084,1083,4550,5696,15146,10246
10709,6569,177,199,1081,701,305,2072,2034,6193,4106
10710,19330,704,862,4520,3163,1525,5185,3371,17764,8556
10801,27670,2688,1701,6879,3416,2207,4853,5926,23281,10779
10803,8414,106,141,904,744,439,2607,3473,8167,6080
10804,10032,197,95,797,770,394,3052,4727,9740,7779
10805,15400,1627,1424,3770,1951,1356,2917,2355,12349,5272
10901,16843,656,796,3391,2416,1306,4326,3952,15391,8278
10910,0,0,0,0,0,0,0,0,0,0
10911,12,0,0,6,0,0,6,0,12,6
10913,3449,45,115,746,512,278,954,799,3289,1753
10914,199,0,0,48,25,108,4,14,199,18
10915,0,0,0,0,0,0,0,0,0,0
10916,2894,64,50,708,642,247,673,510,2780,1183
10917,1114,28,72,97,161,207,289,260,1014,549
10918,8295,60,277,2077,1735,869,1953,1324,7958,3277
10919,1015,4,120,159,130,128,417,57,891,474
10920,5796,140,181,935,1038,562,1709,1231,5475,2940
10921,2941,77,69,922,532,377,559,405,2795,964
10922,923,0,57,267,317,58,99,125,866,224
10923,5680,432,110,1414,1260,469,1477,518,5138,1995
10924,9773,289,499,2692,1391,883,2084,1935,8985,4019
10925,3290,9,313,976,641,280,716,355,2968,1071
10926,2687,84,73,780,412,279,621,438,2530,1059
10927,8173,1023,691,2562,1035,829,1388,645,6459,2033
10928,3721,55,281,1207,535,274,778,591,3385,1369
10930,6481,117,295,1287,1256,871,1317,1338,6069,2655
10931,669,42,58,257,74,63,84,91,569,175
10932,43,0,13,22,8,0,0,0,30,0
10933,208,0,0,84,51,0,31,42,208,73
10940,34756,2386,2342,10964,6525,4449,4618,3472,30028,8090
10941,9984,441,334,3038,2149,1260,1772,990,9209,2762
10950,27731,915,3510,7988,5845,2028,4563,2882,23306,7445
10952,20218,889,2228,5889,5073,928,2901,2310,17101,5211
10953,0,0,0,0,0,0,0,0,0,0
10954,19688,830,1153,3836,3205,1586,5578,3500,17705,9078
10956,21842,620,725,3203,2651,1738,7369,5536,20497,12905
10958,2084,40,344,621,315,247,295,222,1700,517
10960,10540,208,495,1460,1538,596,2781,3462,9837,6243
10962,3917,185,243,547,520,275,1113,1034,3489,2147
10963,3306,108,633,929,531,427,392,286,2565,678
10964,1146,35,5,131,134,63,393,385,1106,778
10965,10543,484,575,1967,1701,743,2610,2463,9484,5073
10968,2058,79,62,156,97,248,753,663,1917,1416
10969,645,21,0,162,197,79,140,46,624,186
10970,7775,507,484,1627,990,540,1887,1740,6784,3627
10973,1560,25,28,383,207,243,421,253,1507,674
10974,2327,34,87,586,322,234,543,521,2206,1064
10975,170,0,0,66,20,62,22,0,170,22
10976,1202,31,44,177,210,141,268,331,1127,599
10977,34495,3833,3461,10172,6548,2127,4618,3736,27201,8354
10979,0,0,0,0,0,0,0,0,0,0
10980,9732,268,533,2590,1632,1182,1681,1846,8931,3527
10983,4183,140,132,578,461,262,1505,1105,3911,2610
10984,2236,57,96,656,321,108,658,340,2083,998
10985,36,0,24,0,6,0,6,0,12,6
10986,1118,24,45,291,165,172,195,226,1049,421
10987,2918,39,92,567,442,273,758,747,2787,1505
10988,420,14,9,123,69,74,26,105,397,131
10989,6761,104,145,1063,877,732,2142,1698,6512,3840
10990,15135,308,475,3688,2498,1231,4495,2440,14352,6935
10992,6531,234,393,2061,1308,575,1252,708,5904,1960
10993,3491,68,328,1122,954,349,436,234,3095,670
10994,4645,144,78,688,616,307,1635,1177,4423,2812
10996,1864,15,7,96,203,40,619,884,1842,1503
10998,2241,29,142,473,383,247,527,440,2070,967
11001,18513,943,645,3631,2283,1195,5830,3986,16925,9816
11003,34070,2041,2316,8762,6937,2842,7216,3956,29713,11172
11004,12052,917,679,2398,1568,700,3233,2557,10456,5790
11005,2175,43,0,255,394,39,591,853,2132,1444
11010,18218,999,650,4864,3107,1495,3837,3266,16569,7103
11020,4070,116,98,757,424,213,1092,1370,3856,2462
11021,14575,402,415,1924,1544,681,4509,5100,13758,9609
11023,5949,75,245,843,384,440,1867,2095,5629,3962
11024,4977,207,317,1049,624,231,1413,1136,4453,2549
11030,11819,152,159,848,679,366,4511,5104,11508,9615
11040,30081,1006,1141,5755,3880,1946,9884,6469,27934,16353
11042,317,60,30,174,12,0,12,29,227,41
11050,22049,573,421,2455,2572,1127,7461,7440,21055,14901
11096,6067,928,679,1638,1009,420,845,548,4460,1393
11101,26873,1624,1138,4144,2065,1111,9112,7679,24111,16791
11102,21370,1605,527,3940,1860,1267,7478,4693,19238,12171
11103,28012,2144,915,5561,2760,1718,9611,5303,24953,14914
11104,20849,1073,555,4183,2803,1787,6101,4347,19221,10448
11105,30070,1770,1416,5236,3498,2244,10091,5815,26884,15906
11106,30987,2197,1460,5935,3937,1706,9631,6121,27330,15752
11109,5601,0,60,360,407,69,2261,2444,5541,4705
11201,51970,1411,1114,4263,3354,1223,19291,21314,49445,40605
11203,58061,3009,4041,20458,10729,4951,9573,5300,51011,14873
11204,50138,8254,5061,13754,5126,2720,10092,5131,36823,15223
11205,28897,1810,2532,5083,3126,1390,9172,5784,24555,14956
11206,55837,6934,6652,13683,7274,2928,12846,5520,42251,18366
11207,65333,6118,6336,23505,11059,5782,8996,3537,52879,12533
11208,69606,6113,6239,34228,8244,4088,7614,3080,57254,10694
11209,52698,3134,2433,9144,6968,3189,15752,12078,47131,27830
11210,42996,2027,2667,9950,7838,3790,10282,6442,38302,16724
11211,45303,3821,3416,7886,4453,1984,16245,7498,38066,23743
11212,57864,4687,9069,20865,9950,4184,6667,2442,44108,9109
11213,45911,3510,4576,11307,8418,3462,8802,5836,37825,14638
11214,64450,10602,4870,16947,6623,4766,13133,7509,48978,20642
11215,53202,1286,1147,3389,2998,2053,19808,22521,50769,42329
11216,48194,1951,2639,9035,5455,2869,16242,10003,43604,26245
11217,33129,1280,1397,2577,2722,1398,12276,11479,30452,23755
11218,48645,3567,3438,9294,5428,2693,12521,11704,41640,24225
11219,47448,8394,5893,17431,4562,1591,6727,2850,33161,9577
11220,62775,14168,9637,15727,4655,2986,9823,5779,38970,15602
11221,65129,4840,5233,15786,8866,3838,17249,9317,55056,26566
11222,32781,1216,1052,4220,3642,1420,13688,7543,30513,21231
11223,52591,7182,4787,14368,5621,2978,10806,6849,40622,17655
11224,35071,2773,3452,10647,3490,2826,6521,5362,28846,11883
11225,43978,2177,2866,8825,6824,2887,13303,7096,38935,20399
11226,73611,4478,5750,21753,11917,4021,16212,9480,63383,25692
11228,32687,4404,1793,9085,3132,1957,7842,4474,26490,12316
11229,57942,4321,3087,15396,6743,4413,14169,9813,50534,23982
11230,59193,5057,5145,12008,7145,4631,14036,11171,48991,25207
11231,27887,1293,1457,3006,2018,856,10015,9242,25137,19257
11232,20295,3472,2821,3922,2210,1015,3860,2995,14002,6855
11233,58249,3596,5071,18972,8757,3740,10665,7448,49582,18113
11234,63718,3796,3519,17611,9460,5198,13836,10298,56403,24134
11235,63558,3616,3009,13568,6563,5247,18012,13543,56933,31555
11236,69911,4647,3651,22175,12731,6828,13168,6711,61613,19879
11237,34954,4280,3994,7207,3969,1730,10308,3466,26680,13774
11238,45762,1093,2126,4770,3655,1887,17389,14842,42543,32231
11239,12188,980,667,4776,1621,1170,1792,1182,10541,2974
11249,28631,1308,2565,4438,2843,1127,9713,6637,24758,16350
11354,43024,5289,3999,12155,4441,4089,8389,4662,33736,13051
11355,62791,10701,8533,17872,6170,5207,8921,5387,43557,14308
11356,19162,2829,1419,5813,2477,2128,2924,1572,14914,4496
11357,31777,3221,1557,8080,4835,2410,6982,4692,26999,11674
11358,28351,2708,2149,7119,3603,2586,6111,4075,23494,10186
11359,0,0,0,0,0,0,0,0,0,0
11360,15729,1105,713,2773,2002,1044,3931,4161,13911,8092
11361,22121,1559,1163,4081,3144,1838,5576,4760,19399,10336
11362,14748,601,617,2382,2037,1329,4561,3221,13530,7782
11363,5458,357,253,500,895,376,1568,1509,4848,3077
11364,27737,2461,1197,5441,3159,2173,7845,5461,24079,13306
11365,32872,3087,1548,7346,5284,3176,7608,4823,28237,12431
11366,9789,802,511,1673,1084,646,2997,2076,8476,5073
11367,28346,2704,1601,6487,2761,2265,7217,5311,24041,12528
11368,75326,19519,7299,24105,9193,4926,7941,2343,48508,10284
11369,23134,2602,2255,7985,3357,1916,3334,1685,18277,5019
11370,21254,2512,2740,7251,2051,1413,3517,1770,16002,5287
11371,0,0,0,0,0,0,0,0,0,0
11372,50209,5897,3468,14064,5964,3672,9135,8009,40844,17144
11373,72670,12481,5983,20013,6766,5313,16139,5975,54206,22114
11374,35610,1857,1535,6441,3877,3305,10961,7634,32218,18595
11375,58743,2256,1324,7823,7154,3620,19355,17211,55163,36566
11377,65544,7808,4303,20607,6700,5122,14101,6903,53433,21004
11378,26947,2022,2000,8828,4611,2198,5064,2224,22925,7288
11379,28619,2018,1996,7802,4604,1905,6225,4069,24605,10294
11385,74477,6822,5000,21783,10227,6016,16635,7994,62655,24629
11411,16130,478,728,4409,3762,1515,2929,2309,14924,5238
11412,28976,1153,1929,9307,6696,2590,4666,2635,25894,7301
11413,31498,1066,1541,9794,7365,2713,5207,3812,28891,9019
11414,22440,1461,1319,6568,4389,1705,4033,2965,19660,6998
11415,15411,1044,770,2526,1955,1284,4265,3567,13597,7832
11416,18580,2409,1876,5424,2562,1552,3478,1279,14295,4757
11417,21094,2503,1946,5767,3684,1694,3415,2085,16645,5500
11418,26371,2959,2310,7593,4030,1584,4837,3058,21102,7895
11419,35168,5883,3413,11479,4964,2364,4783,2282,25872,7065
11420,37248,4779,3370,12064,6091,2961,5499,2484,29099,7983
11421,29130,3679,2465,8451,4333,2493,5407,2302,22986,7709
11422,23843,1082,1495,6576,5338,2226,4565,2561,21266,7126
11423,22020,1806,1516,5611,3491,1996,4976,2624,18698,7600
11424,0,0,0,0,0,0,0,0,0,0
11426,14645,822,894,3265,2281,1173,3938,2272,12929,6210
11427,18763,1668,1466,4271,2866,1990,3893,2609,15629,6502
11428,14561,1554,1056,4368,2225,1379,2710,1269,11951,3979
11429,19662,1311,1636,6176,3730,1449,3354,2006,16715,5360
11430,200,0,17,65,81,19,12,6,183,18
11432,44701,5024,3501,9865,6414,3434,10572,5891,36176,16463
11433,25282,3027,2505,8550,4970,1839,3193,1198,19750,4391
11434,46920,2383,3708,14570,11820,4067,6732,3640,40829,10372
11435,41895,4841,3363,9175,7180,3349,8721,5266,33691,13987
11436,14882,989,1274,5391,2855,1022,2224,1127,12619,3351
11439,7,0,0,0,0,0,7,0,7,7
11451,0,0,0,0,0,0,0,0,0,0
11501,16617,1098,814,2906,1940,1106,4830,3923,14705,8753
11507,5108,234,81,698,459,367,1669,1600,4793,3269
11509,1350,3,27,194,205,124,423,374,1320,797
11510,24912,1062,582,5089,5056,2522,5768,4833,23268,10601
11514,3376,55,58,726,494,311,1054,678,3263,1732
11516,5080,13,131,966,1092,580,928,1370,4936,2298
11518,7379,323,247,1917,1073,610,1754,1455,6809,3209
11520,31519,3161,2048,9699,5331,2848,5330,3102,26310,8432
11530,18290,225,467,2227,1502,986,6208,6675,17598,12883
11542,20794,2119,898,5014,2929,1067,5124,3643,17777,8767
11545,8453,146,136,952,1045,512,2714,2948,8171,5662
11547,422,15,18,33,96,16,165,79,389,244
11548,993,13,47,133,59,58,401,282,933,683
11549,45,0,0,9,11,0,20,5,45,25
11550,40250,6414,3371,13149,7013,2950,4427,2926,30465,7353
11552,16962,630,644,3801,2518,1527,4181,3661,15688,7842
11553,18222,2383,1620,5852,2785,1604,2072,1906,14219,3978
11554,26182,755,1269,6429,3788,2174,6628,5139,24158,11767
11556,0,0,0,0,0,0,0,0,0,0
11557,5599,51,270,619,588,300,2076,1695,5278,3771
11558,6742,140,210,2281,1504,593,1132,882,6392,2014
11559,4929,270,270,660,583,140,1734,1272,4389,3006
11560,4798,295,172,522,760,189,1487,1373,4331,2860
11561,30708,629,579,6509,4837,2101,8606,7447,29500,16053
11563,16206,732,628,3660,2502,1220,4275,3189,14846,7464
11565,6602,75,95,1005,910,446,2304,1767,6432,4071
11566,24066,358,642,4373,2922,1777,7465,6529,23066,13994
11568,2144,15,14,186,173,73,812,871,2115,1683
11569,861,11,6,127,122,88,252,255,844,507
11570,20076,536,564,2766,2358,1533,6371,5948,18976,12319
11572,21603,654,551,5678,2731,1707,5328,4954,20398,10282
11575,12046,1278,896,3987,1774,1143,2117,851,9872,2968
11576,9116,70,78,717,704,480,3119,3948,8968,7067
11577,8522,124,117,947,711,503,2877,3243,8281,6120
11579,3494,56,42,695,370,240,886,1205,3396,2091
11580,31313,1753,1499,7331,5200,3460,7999,4071,28061,12070
11581,15128,915,475,3083,2097,1092,4430,3036,13738,7466
11590,33276,2954,2059,7159,4976,2484,8358,5286,28263,13644
11596,7017,110,156,1099,1211,511,2082,1848,6751,3930
11598,8271,300,105,1112,832,218,2528,3176,7866,5704
11691,43301,4760,3978,12355,7489,3851,6112,4756,34563,10868
11692,15490,1275,1200,4416,2644,1521,2505,1929,13015,4434
11693,9683,644,747,2704,1326,806,2156,1300,8292,3456
11694,15723,735,906,3831,2615,826,3496,3314,14082,6810
11697,2916,25,169,365,553,274,780,750,2722,1530
11701,19603,1555,1288,5299,3329,2327,2865,2940,16760,5805
11702,10747,181,182,2112,1653,926,3129,2564,10384,5693
11703,11926,302,583,3202,2338,1695,2454,1352,11041,3806
11704,29095,1890,1486,8869,4979,3024,4893,3954,25719,8847
11705,5951,33,106,1017,966,519,1718,1592,5812,3310
11706,44282,3562,3165,13082,7979,4265,6793,5436,37555,12229
11709,5115,112,132,993,842,328,1322,1386,4871,2708
11710,24722,242,547,5195,3626,2106,7166,5840,23933,13006
11713,6128,340,344,1731,1239,600,999,875,5444,1874
11714,16138,431,497,4402,2485,1493,4170,2660,15210,6830
11715,2869,30,23,793,286,298,719,720,2816,1439
11716,7162,129,272,2137,1095,788,1728,1013,6761,2741
11717,44075,9517,3726,12886,7327,3053,4575,2991,30832,7566
11718,2067,17,12,268,317,219,709,525,2038,1234
11719,2438,83,93,774,446,206,428,408,2262,836
11720,19647,552,1039,5529,3467,2109,3514,3437,18056,6951
11721,4846,89,19,434,565,307,1840,1592,4738,3432
11722,23644,3428,2431,7504,4234,1650,2742,1655,17785,4397
11724,1798,50,11,113,122,57,706,739,1737,1445
11725,19888,282,332,3225,2807,1780,6113,5349,19274,11462
11726,14464,925,1744,4210,2492,1639,2237,1217,11795,3454
11727,21360,569,1411,6016,4634,2235,3976,2519,19380,6495
11729,19092,671,575,4994,3725,1861,4055,3211,17846,7266
11730,10185,256,311,2790,1996,1081,1948,1803,9618,3751
11731,21487,372,430,4388,3630,1984,5691,4992,20685,10683
11732,2762,10,17,500,392,307,908,628,2735,1536
11733,11861,179,164,1672,1328,1017,2753,4748,11518,7501
11735,23562,1082,623,5829,3642,1960,6056,4370,21857,10426
11738,13017,760,854,3794,1982,1515,2493,1619,11403,4112
11739,1016,0,39,202,83,95,281,316,977,597
11740,7516,343,166,1468,900,670,2044,1925,7007,3969
11741,19328,542,992,5407,3461,2078,3944,2904,17794,6848
11742,9561,443,494,2810,1680,897,1763,1474,8624,3237
11743,29957,855,500,3686,3542,2360,9520,9494,28602,19014
11746,47732,3236,1977,8374,6479,3804,12413,11449,42519,23862
11747,15025,616,251,1735,1968,1149,4564,4742,14158,9306
11749,2663,170,105,789,507,338,395,359,2388,754
11751,10317,889,381,2861,1450,1087,1933,1716,9047,3649
11752,6715,200,146,2143,1381,677,1161,1007,6369,2168
11753,8624,275,222,971,484,443,2964,3265,8127,6229
11754,13199,247,290,2945,2422,1416,3134,2745,12662,5879
11755,8246,155,251,1971,1227,699,2257,1686,7840,3943
11756,30418,817,1327,8465,5681,3344,5803,4981,28274,10784
11757,32609,1471,1396,11008,6046,3194,5864,3630,29742,9494
11758,39496,825,654,10041,5659,3565,10333,8419,38017,18752
11762,16187,178,276,3811,2417,1554,4334,3617,15733,7951
11763,20923,1022,1166,6954,3800,2444,3345,2192,18735,5537
11764,8491,254,201,2048,1177,932,1893,1986,8036,3879
11765,473,6,15,24,34,18,155,221,452,376
11766,8051,165,363,1705,1088,768,1981,1981,7523,3962
11767,9902,216,207,2665,1508,895,2825,1586,9479,4411
11768,15491,104,113,1948,2186,1545,4935,4660,15274,9595
11769,7069,79,122,1659,1058,929,1866,1356,6868,3222
11770,86,13,0,19,21,13,14,6,73,20
11771,7101,59,272,888,956,584,2342,2000,6770,4342
11772,32662,1626,1828,8972,5997,3997,5848,4394,29208,10242
11776,16363,421,912,4493,2918,1227,3778,2614,15030,6392
11777,6701,106,171,967,722,402,1605,2728,6424,4333
11778,8378,309,177,2459,1616,736,1736,1345,7892,3081
11779,26800,717,866,8921,5279,2922,4670,3425,25217,8095
11780,11020,198,279,1825,1817,989,2904,3008,10543,5912
11782,10730,162,280,1926,1730,883,3207,2542,10288,5749
11783,15217,319,209,3575,2591,1733,3870,2920,14689,6790
11784,17193,488,647,5694,3294,2157,2875,2038,16058,4913
11786,4235,229,95,779,713,505,780,1134,3911,1914
11787,24159,584,541,4800,3467,2416,6742,5609,23034,12351
11788,11904,447,395,2298,1689,1322,3237,2516,11062,5753
11789,5055,17,94,1284,1061,560,1124,915,4944,2039
11790,9037,27,77,1212,862,773,2324,3762,8933,6086
11791,17009,317,321,1959,1571,1074,5768,5999,16371,11767
11792,6075,224,204,1104,1154,506,1229,1654,5647,2883
11793,21418,429,322,4753,3599,1875,5669,4771,20667,10440
11794,57,0,0,0,5,1,44,7,57,51
11795,17538,290,377,3826,2828,2043,4272,3902,16871,8174
11796,2782,52,75,676,527,308,526,618,2655,1144
11797,6910,157,147,998,698,316,2383,2211,6606,4594
11798,11687,2056,1151,3614,1871,589,1404,1002,8480,2406
11801,30147,1424,1223,7544,4444,2835,7672,5005,27500,12677
11803,21105,229,355,2696,2504,1143,6951,7227,20521,14178
11804,3044,6,39,495,342,101,991,1070,2999,2061
11901,23586,2561,2089,8298,3411,2057,3051,2119,18936,5170
11930,602,2,0,112,25,72,198,193,600,391
11931,0,0,0,0,0,0,0,0,0,0
11932,786,33,34,130,40,41,382,126,719,508
11933,5377,154,211,1589,1083,712,863,765,5012,1628
11934,5150,164,191,1090,933,790,886,1096,4795,1982
11935,2425,39,61,278,408,326,795,518,2325,1313
11937,15446,793,481,3149,1605,1095,4319,4004,14172,8323
11939,1303,30,0,272,219,233,320,229,1273,549
11940,3841,160,32,1204,837,400,568,640,3649,1208
11941,1896,49,68,440,284,377,414,264,1779,678
11942,4183,134,228,528,728,509,1103,953,3821,2056
11944,3934,314,180,821,770,250,976,623,3440,1599
11946,12351,1012,588,2868,2069,903,2707,2204,10751,4911
11947,153,0,0,84,69,0,0,0,153,0
11948,412,0,4,130,14,76,72,116,408,188
11949,9739,102,236,3445,2210,915,1408,1423,9401,2831
11950,10246,620,973,4248,1751,876,1137,641,8653,1778
11951,9756,337,901,3590,1646,1432,1114,736,8518,1850
11952,4034,221,67,733,864,270,1165,714,3746,1879
11953,10112,227,641,3136,2080,783,1794,1451,9244,3245
11954,3251,40,96,684,543,281,1009,598,3115,1607
11955,2264,72,75,722,341,293,476,285,2117,761
11956,243,0,4,31,35,21,113,39,239,152
11957,1135,22,6,216,180,62,366,283,1107,649
11958,680,100,0,174,66,70,144,126,580,270
11959,436,7,1,168,52,53,103,52,428,155
11960,764,0,11,190,60,40,279,184,753,463
11961,9895,258,385,3365,1809,835,1917,1326,9252,3243
11962,269,37,0,41,14,16,90,71,232,161
11963,6308,54,308,1240,846,230,1781,1849,5946,3630
11964,2106,0,291,282,279,60,555,639,1815,1194
11965,341,0,3,0,47,0,205,86,338,291
11967,18648,872,1012,6742,4108,2175,2433,1306,16764,3739
11968,10525,41,161,1874,1372,692,3210,3175,10323,6385
11970,563,0,0,113,0,158,189,103,563,292
11971,4707,133,301,1080,637,313,1189,1054,4273,2243
11972,279,8,6,137,0,0,46,82,265,128
11973,4,0,0,0,0,0,2,2,4,4
11975,372,2,2,71,49,23,142,83,368,225
11976,2040,6,32,248,163,44,819,728,2002,1547
11977,2248,36,86,372,251,278,652,573,2126,1225
11978,2810,85,73,520,394,113,884,741,2652,1625
11980,3960,23,91,1376,591,455,789,635,3846,1424
12007,239,0,0,84,55,8,21,71,239,92
12008,281,0,0,33,61,71,77,39,281,116
12009,5925,57,193,1149,725,665,1511,1625,5675,3136
12010,19279,820,1378,6484,3516,2758,2627,1696,17081,4323
12015,3249,60,59,1034,476,318,556,746,3130,1302
12017,354,0,17,82,61,13,118,63,337,181
12018,5503,58,143,1394,899,787,1131,1091,5302,2222
12019,11365,78,263,1923,1484,1523,3157,2937,11024,6094
12020,24746,379,1101,6227,3820,2850,5713,4656,23266,10369
12022,704,44,84,256,82,70,104,64,576,168
12023,1503,8,28,697,212,118,267,173,1467,440
12024,76,0,0,26,9,12,16,13,76,29
12025,3984,69,193,1204,781,698,646,393,3722,1039
12027,2888,34,25,732,256,371,861,609,2829,1470
12028,715,6,56,260,168,90,57,78,653,135
12029,803,0,20,193,110,132,149,199,783,348
12031,160,0,31,49,22,25,29,4,129,33
12032,588,0,55,284,33,115,48,53,533,101
12033,5852,84,264,1568,1109,940,1100,787,5504,1887
12035,369,8,4,122,85,57,36,57,357,93
12036,137,4,6,74,12,3,29,9,127,38
12037,3023,20,122,616,565,431,489,780,2881,1269
12040,28,0,0,11,2,8,7,0,28,7
12041,310,11,0,91,57,76,62,13,299,75
12042,228,0,3,57,75,22,71,0,225,71
12043,4891,100,259,1467,911,628,931,595,4532,1526
12045,233,1,12,80,119,0,0,21,220,21
12046,422,29,20,236,47,43,47,0,373,47
12047,15537,196,1088,4154,2168,2823,2855,2253,14253,5108
12051,4508,211,1294,1149,559,270,719,306,3003,1025
12052,1376,3,62,365,343,214,171,218,1311,389
12053,3070,18,228,677,609,611,544,383,2824,927
12054,12215,151,83,1280,1146,938,3388,5229,11981,8617
12056,1504,7,30,374,381,214,310,188,1467,498
12057,1351,15,75,497,227,251,211,75,1261,286
12058,889,0,17,482,152,138,66,34,872,100
12059,1100,3,25,457,228,91,182,114,1072,296
12060,1560,28,34,225,362,172,316,423,1498,739
12061,7351,155,234,1342,990,704,1904,2022,6962,3926
12062,1258,3,117,490,179,108,209,152,1138,361
12063,509,0,0,64,142,129,66,108,509,174
12064,197,4,12,111,41,0,8,21,181,29
12065,31633,677,717,5195,4471,3608,9091,7874,30239,16965
12066,1386,21,79,575,260,168,207,76,1286,283
12067,1048,0,56,342,117,268,119,146,992,265
12068,1737,92,80,532,415,362,125,131,1565,256
12069,298,0,25,73,148,11,8,33,273,41
12070,1643,2,178,525,399,221,121,197,1463,318
12071,169,0,11,60,24,20,26,28,158,54
12072,1876,147,103,703,338,300,186,99,1626,285
12074,2137,14,168,676,478,193,351,257,1955,608
12075,2363,184,107,475,323,381,564,329,2072,893
12076,1010,47,68,370,152,134,143,96,895,239
12077,4708,26,185,589,456,453,1282,1717,4497,2999
12078,16295,724,1526,5754,2971,2553,1546,1221,14045,2767
12082,2,0,0,0,0,0,0,2,2,2
12083,2586,14,93,828,434,340,524,353,2479,877
12084,3465,23,47,461,424,351,1047,1112,3395,2159
12085,219,18,11,100,40,9,36,5,190,41
12086,1232,14,56,458,219,185,200,100,1162,300
12087,866,5,68,331,115,113,95,139,793,234
12090,4047,76,270,1567,675,505,611,343,3701,954
12092,1186,5,93,305,373,108,66,236,1088,302
12093,1100,25,60,360,217,141,154,143,1015,297
12094,1952,60,88,686,232,347,413,126,1804,539
12095,9365,227,887,3470,1310,1303,1424,744,8251,2168
12106,1659,23,32,278,294,146,475,411,1604,886
12108,337,17,99,67,39,53,30,32,221,62
12110,13470,356,490,2842,1974,1667,3775,2366,12624,6141
12115,95,0,0,10,11,12,33,29,95,62
12116,1036,1,43,478,124,96,189,105,992,294
12117,2187,112,177,821,386,347,184,160,1898,344
12118,11939,261,606,3789,1955,1494,2335,1499,11072,3834
12120,451,2,26,166,95,30,36,96,423,132
12121,1623,0,28,797,230,270,202,96,1595,298
12122,2838,103,211,1177,508,307,299,233,2524,532
12123,3545,32,90,836,610,585,892,500,3423,1392
12124,204,2,1,55,61,0,18,67,201,85
12125,850,0,43,265,137,88,198,119,807,317
12130,221,0,26,61,7,20,73,34,195,107
12131,124,7,1,56,20,8,24,8,116,32
12132,97,0,15,17,0,0,15,50,82,65
12134,3358,47,337,1252,485,439,485,313,2974,798
12136,688,10,11,117,120,31,239,160,667,399
12137,1370,11,37,442,238,164,215,263,1322,478
12138,2050,93,129,689,415,266,266,192,1828,458
12139,249,0,5,72,82,29,28,33,244,61
12140,1071,11,15,312,154,149,271,159,1045,430
12143,3756,92,327,1380,496,516,580,365,3337,945
12144,16403,548,497,4308,2693,2368,3655,2334,15358,5989
12147,353,0,26,72,21,85,60,89,327,149
12148,3338,118,77,477,370,382,1022,892,3143,1914
12149,1615,46,84,629,295,216,240,105,1485,345
12150,419,6,0,192,109,20,78,14,413,92
12151,679,0,34,135,80,65,215,150,645,365
12153,545,3,56,135,140,89,79,43,486,122
12154,2183,8,169,735,456,149,352,314,2006,666
12155,1238,14,94,503,175,192,163,97,1130,260
12156,524,0,8,121,134,89,127,45,516,172
12157,3279,82,234,1122,554,376,349,562,2963,911
12158,4716,82,247,1174,705,597,969,942,4387,1911
12159,6590,65,91,841,751,467,1592,2783,6434,4375
12160,670,3,87,281,128,77,66,28,580,94
12161,26,0,0,0,0,8,8,10,26,18
12164,412,0,34,116,57,73,41,91,378,132
12165,149,0,0,10,25,3,46,65,149,111
12166,1119,25,69,382,218,203,158,64,1025,222
12167,1892,66,115,716,247,294,204,250,1711,454
12168,1325,53,35,307,183,229,408,110,1237,518
12169,251,28,0,60,63,54,38,8,223,46
12170,3847,57,220,1385,654,623,676,232,3570,908
12172,66,0,0,26,18,18,2,2,66,4
12173,1260,0,31,425,262,200,208,134,1229,342
12174,470,18,0,53,197,163,23,16,452,39
12175,509,5,8,237,67,65,81,46,496,127
12176,226,15,0,129,31,16,31,4,211,35
12177,310,0,0,113,45,67,0,85,310,85
12180,35527,1288,2209,8517,5837,4413,7369,5894,32030,13263
12182,10448,386,833,3203,1862,1374,1840,950,9229,2790
12183,2010,112,157,836,304,243,135,223,1741,358
12184,5519,182,140,1729,776,684,1003,1005,5197,2008
12185,1263,0,84,413,300,80,235,151,1179,386
12186,4533,24,153,736,641,594,1371,1014,4356,2385
12187,478,3,29,59,178,104,29,76,446,105
12188,8916,191,327,2392,1755,1206,1956,1089,8398,3045
12189,12838,484,613,3729,3030,1599,1841,1542,11741,3383
12190,454,29,86,146,97,34,35,27,339,62
12192,1195,164,158,394,136,105,148,90,873,238
12193,1333,13,70,555,233,125,167,170,1250,337
12194,120,0,13,42,9,29,22,5,107,27
12195,184,0,0,0,0,137,0,47,184,47
12196,2457,62,69,660,261,464,630,311,2326,941
12197,1492,21,45,469,273,289,215,180,1426,395
12198,5298,46,117,1230,886,1033,1247,739,5135,1986
12202,6650,603,626,1557,1169,577,1325,793,5421,2118
12203,19848,639,591,3530,2669,1728,5247,5444,18618,10691
12204,5925,245,347,1256,733,629,1596,1119,5333,2715
12205,19137,721,706,4819,2987,2955,3706,3243,17710,6949
12206,9368,655,1085,2916,1700,940,884,1188,7628,2072
12207,1705,76,132,503,256,183,182,373,1497,555
12208,14953,391,614,2240,2090,1500,3990,4128,13948,8118
12209,6910,533,255,1406,1180,688,1766,1082,6122,2848
12210,7531,206,580,1487,1750,393,1650,1465,6745,3115
12211,7810,55,121,1400,1205,646,2136,2247,7634,4383
12222,58,0,0,10,16,0,25,7,58,32
12226,0,0,0,0,0,0,0,0,0,0
12302,19578,355,698,4612,3531,2319,4572,3491,18525,8063
12303,20322,692,1044,5652,3409,2900,3719,2906,18586,6625
12304,15173,946,1205,4681,2722,2123,2166,1330,13022,3496
12305,4696,158,406,993,1047,521,925,646,4132,1571
12306,19674,300,934,5977,4092,2795,3132,2444,18440,5576
12307,4590,499,618,1702,915,375,345,136,3473,481
12308,9391,479,590,2709,1702,1217,1644,1050,8322,2694
12309,23192,247,489,3608,2903,2584,6315,7046,22456,13361
12401,25516,950,1920,8166,4869,2134,4243,3234,22646,7477
12404,2779,75,320,435,290,338,671,650,2384,1321
12405,427,0,0,173,94,27,68,65,427,133
12406,529,41,134,221,14,23,75,21,354,96
12407,114,0,4,49,47,5,9,0,110,9
12409,812,9,9,83,133,96,185,297,794,482
12410,309,5,0,30,117,43,99,15,304,114
12411,308,0,0,97,92,9,50,60,308,110
12412,492,26,41,68,66,34,219,38,425,257
12413,2280,211,64,790,396,305,184,330,2005,514
12414,7791,367,504,2712,1193,826,1361,828,6920,2189
12416,205,0,48,34,55,10,58,0,157,58
12417,767,0,28,359,219,86,0,75,739,75
12418,241,9,13,77,10,31,73,28,219,101
12419,624,0,22,76,203,22,133,168,602,301
12420,211,0,10,74,16,30,81,0,201,81
12421,211,0,7,32,37,32,28,75,204,103
12422,318,0,25,154,66,12,61,0,293,61
12423,749,94,13,227,127,119,102,67,642,169
12424,239,4,24,78,71,0,29,33,211,62
12427,684,10,0,97,108,168,272,29,674,301
12428,4946,55,513,1556,863,597,675,687,4378,1362
12429,153,0,0,153,0,0,0,0,153,0
12430,984,113,66,275,172,19,138,201,805,339
12431,1393,73,8,494,232,192,286,108,1312,394
12432,445,30,27,234,77,20,35,22,388,57
12433,413,0,0,155,38,39,95,86,413,181
12434,724,7,63,210,181,168,80,15,654,95
12435,188,0,0,60,60,30,0,38,188,38
12436,421,35,0,116,58,50,139,23,386,162
12438,39,0,7,15,0,0,9,8,32,17
12439,254,0,9,79,48,60,21,37,245,58
12440,1293,18,32,320,217,58,252,396,1243,648
12441,105,0,0,26,34,0,11,34,105,45
12442,548,4,11,233,102,60,103,35,533,138
12443,2830,82,49,622,378,380,554,765,2699,1319
12444,429,6,14,171,55,41,99,43,409,142
12446,3363,157,112,955,598,370,664,507,3094,1171
12448,142,0,12,7,27,14,20,62,130,82
12449,2491,131,176,770,417,298,500,199,2184,699
12450,166,0,10,44,47,10,55,0,156,55
12451,857,26,14,488,148,53,117,11,817,128
12452,27,0,0,0,0,11,16,0,27,16
12453,240,0,0,120,0,13,13,94,240,107
12454,278,2,51,34,39,6,94,52,225,146
12455,1345,57,72,418,197,231,192,178,1216,370
12456,473,26,6,217,69,88,67,0,441,67
12457,870,6,32,206,204,82,98,242,832,340
12458,3063,179,1062,1024,385,160,128,125,1822,253
12459,60,0,5,7,28,0,0,20,55,20
12460,159,0,0,54,22,8,33,42,159,75
12461,971,0,26,255,207,51,178,254,945,432
12463,1129,0,32,528,88,196,145,140,1097,285
12464,957,0,46,76,204,175,314,142,911,456
12465,366,0,18,58,76,0,39,175,348,214
12466,1446,10,51,409,417,100,302,157,1385,459
12468,1104,31,57,496,171,126,143,80,1016,223
12469,716,26,23,265,97,66,201,38,667,239
12470,513,0,86,168,0,69,92,98,427,190
12471,268,0,0,0,218,0,0,50,268,50
12472,969,24,55,118,224,59,281,208,890,489
12473,558,10,7,278,62,92,86,23,541,109
12474,735,13,50,295,74,89,125,89,672,214
12475,385,22,0,211,68,12,35,37,363,72
12477,13971,418,747,3645,2286,2326,2537,2012,12806,4549
12480,274,0,0,28,76,0,114,56,274,170
12481,1312,0,126,523,134,161,169,199,1186,368
12482,410,0,19,301,48,21,21,0,391,21
12483,49,0,0,28,8,0,0,13,49,13
12484,2572,3,44,387,215,117,979,827,2525,1806
12485,610,10,19,276,44,104,59,98,581,157
12486,1464,0,37,389,453,163,227,195,1427,422
12487,3073,44,122,1015,482,422,447,541,2907,988
12489,154,0,20,53,21,41,19,0,134,19
12490,0,0,0,0,0,0,0,0,0,0
12491,1403,0,14,277,317,117,340,338,1389,678
12492,152,0,3,38,41,12,41,17,149,58
12493,307,0,18,20,0,0,90,179,289,269
12494,560,0,14,29,14,52,382,69,546,451
12495,87,0,0,49,0,0,12,26,87,38
12496,1031,72,72,271,134,153,116,213,887,329
12498,3934,56,94,553,607,237,1245,1142,3784,2387
12501,1607,120,169,474,111,153,306,274,1318,580
12502,882,25,62,284,79,111,155,166,795,321
12503,548,6,32,186,39,25,103,157,510,260
12504,13,0,0,4,9,0,0,0,13,0
12507,110,0,3,21,15,4,15,52,107,67
12508,14561,486,1610,3403,2170,1036,3284,2572,12465,5856
12512,142,0,0,45,0,0,81,16,142,97
12513,154,0,0,50,0,0,29,75,154,104
12514,2433,190,119,470,235,159,698,562,2124,1260
12515,1265,17,40,444,262,134,281,87,1208,368
12516,1620,116,100,624,152,80,252,296,1404,548
12517,326,0,0,222,53,5,6,40,326,46
12518,4205,52,125,784,656,514,1061,1013,4028,2074
12520,2216,4,26,285,309,334,473,785,2186,1258
12521,1383,32,39,511,87,169,220,325,1312,545
12522,3725,262,341,1172,658,367,612,313,3122,925
12523,1543,35,68,573,173,235,384,75,1440,459
12524,12151,206,700,3468,2398,1229,2222,1928,11245,4150
12525,1202,0,16,456,269,71,258,132,1186,390
12526,2905,58,120,693,437,339,601,657,2727,1258
12527,16,0,0,0,0,0,16,0,16,16
12528,9743,250,310,2418,1643,1091,2331,1700,9183,4031
12529,1897,25,137,398,232,197,465,443,1735,908
12530,283,0,121,118,44,0,0,0,162,0
12531,1820,16,62,560,334,140,361,347,1742,708
12533,17534,230,677,3803,2952,1676,4461,3735,16627,8196
12534,13496,506,1073,4621,1438,1791,2310,1757,11917,4067
12538,9496,231,463,3108,1538,1314,1450,1392,8802,2842
12540,6035,76,187,1520,1057,590,1339,1266,5772,2605
12542,4164,131,122,1013,690,482,1015,711,3911,1726
12543,2282,90,88,830,580,273,284,137,2104,421
12544,33,0,0,0,15,18,0,0,33,0
12545,3591,92,65,931,576,451,648,828,3434,1476
12546,2015,84,82,602,254,234,380,379,1849,759
12547,2423,109,42,704,554,274,424,316,2272,740
12548,856,61,50,220,144,132,160,89,745,249
12549,7097,126,318,1812,1621,943,1395,882,6653,2277
12550,37705,2430,2829,11213,7378,3830,5849,4176,32446,10025
12553,18614,590,1358,4884,3513,1797,3357,3115,16666,6472
12561,10515,209,133,2084,1680,791,2792,2826,10173,5618
12563,5808,263,241,1985,1214,447,1060,598,5304,1658
12564,5470,189,118,1444,935,487,1416,881,5163,2297
12565,1085,8,40,380,196,132,204,125,1037,329
12566,8931,168,379,2995,1832,1190,1512,855,8384,2367
12567,1856,32,105,532,270,187,386,344,1719,730
12569,6655,123,185,2118,1095,774,1157,1203,6347,2360
12570,4650,35,155,1182,694,477,1051,1056,4460,2107
12571,6546,116,199,1295,782,693,1700,1761,6231,3461
12572,7646,165,292,1419,1250,820,1899,1801,7189,3700
12574,277,0,0,30,18,0,68,161,277,229
12575,1093,90,36,357,153,37,285,135,967,420
12577,1242,0,56,243,306,74,229,334,1186,563
12578,1709,21,22,529,365,147,336,289,1666,625
12580,3451,278,211,788,438,330,764,642,2962,1406
12581,1530,22,37,373,249,291,274,284,1471,558
12582,4834,346,903,1319,655,333,849,429,3585,1278
12583,1220,15,22,271,209,133,244,326,1183,570
12585,702,36,28,155,112,89,87,195,638,282
12586,8304,392,527,2356,1572,1024,1522,911,7385,2433
12589,14365,241,1301,5764,2710,1115,2008,1226,12823,3234
12590,27765,813,1392,7235,5092,3290,5382,4561,25560,9943
12592,926,6,117,390,148,30,113,122,803,235
12594,3107,72,220,1114,574,305,496,326,2815,822
12601,28712,1286,2041,8588,5265,2824,4831,3877,25385,8708
12603,30444,642,1188,6539,5113,2928,6934,7100,28614,14034
12604,45,0,0,0,32,13,0,0,45,0
12701,8700,923,1163,2811,1255,843,1132,573,6614,1705
12719,943,76,74,244,214,95,112,128,793,240
12720,172,0,9,53,41,31,38,0,163,38
12721,4889,234,220,1535,1212,539,832,317,4435,1149
12722,0,0,0,0,0,0,0,0,0,0
12723,1460,9,45,310,226,217,392,261,1406,653
12724,78,0,18,0,17,19,15,9,60,24
12725,195,9,11,68,11,21,39,36,175,75
12726,1054,18,51,271,274,82,229,129,985,358
12729,1026,9,72,397,196,137,125,90,945,215
12732,743,0,21,338,114,99,67,104,722,171
12733,1470,124,451,449,291,47,86,22,895,108
12734,740,92,25,328,173,0,66,56,623,122
12736,122,0,0,52,34,0,31,5,122,36
12737,1029,43,38,261,162,125,254,146,948,400
12738,258,0,0,138,87,10,0,23,258,23
12740,1278,17,56,314,377,87,126,301,1205,427
12741,153,0,0,65,51,2,17,18,153,35
12742,145,6,17,59,28,3,5,27,122,32
12743,279,11,5,112,42,23,4,82,263,86
12745,5,0,0,0,5,0,0,0,5,0
12746,474,0,15,165,125,87,20,62,459,82
12747,1453,23,47,328,444,154,183,274,1383,457
12748,1381,28,97,417,278,115,271,175,1256,446
12749,402,0,0,193,79,65,65,0,402,65
12750,32,0,0,8,3,0,17,4,32,21
12751,505,0,28,239,101,49,29,59,477,88
12752,282,0,0,83,80,22,11,86,282,97
12754,4835,461,224,2138,672,461,498,381,4150,879
12758,3012,93,173,1037,416,432,493,368,2746,861
12759,830,36,104,312,115,78,123,62,690,185
12760,376,0,0,161,65,19,83,48,376,131
12762,224,9,31,86,91,7,0,0,184,0
12763,410,0,31,87,39,18,96,139,379,235
12764,1376,43,133,260,311,139,317,173,1200,490
12765,690,0,17,115,112,123,173,150,673,323
12766,536,0,68,114,71,13,162,108,468,270
12767,172,0,0,80,21,31,40,0,172,40
12768,611,55,21,179,153,48,85,70,535,155
12769,337,0,21,134,57,60,55,10,316,65
12770,144,0,7,22,18,27,45,25,137,70
12771,9771,412,587,4000,1789,1035,1030,918,8772,1948
12775,1953,9,173,331,278,155,538,469,1771,1007
12776,1595,61,102,456,275,156,317,228,1432,545
12777,695,23,41,172,74,56,118,211,631,329
12778,303,22,0,134,23,40,56,28,281,84
12779,1425,150,279,302,193,263,167,71,996,238
12780,1659,20,61,717,181,255,300,125,1578,425
12781,182,12,33,87,7,0,43,0,137,43
12783,993,111,49,311,228,66,139,89,833,228
12784,0,0,0,0,0,0,0,0,0,0
12785,678,30,2,171,354,62,32,27,646,59
12786,489,48,2,60,111,52,165,51,439,216
12787,97,0,0,83,7,7,0,0,97,0
12788,2301,179,375,723,293,304,151,276,1747,427
12789,1418,33,27,278,236,209,415,220,1358,635
12790,3239,106,135,1145,567,177,688,421,2998,1109
12791,368,5,0,147,69,58,42,47,363,89
12792,131,0,0,51,0,12,36,32,131,68
12801,10312,262,898,3017,1789,1266,1677,1403,9152,3080
12803,5964,75,368,1603,1439,724,1144,611,5521,1755
12804,20886,410,809,5319,3680,2364,4286,4018,19667,8304
12808,197,0,12,46,39,25,34,41,185,75
12809,2676,75,168,1104,514,284,296,235,2433,531
12810,424,23,69,155,64,38,36,39,332,75
12811,161,0,17,117,7,6,14,0,144,14
12812,344,4,0,8,80,179,20,53,340,73
12814,1010,8,9,431,155,167,114,126,993,240
12815,861,23,45,289,141,143,102,118,793,220
12816,3290,67,170,1029,600,367,534,523,3053,1057
12817,1560,48,91,466,223,120,325,287,1421,612
12819,200,3,14,114,32,17,3,17,183,20
12820,58,0,0,0,12,14,0,32,58,32
12821,2025,255,569,967,129,40,60,5,1201,65
12822,4321,216,317,1804,704,648,436,196,3788,632
12823,357,0,0,23,26,0,235,73,357,308
12824,876,0,56,183,189,80,181,187,820,368
12827,2622,63,119,1010,485,454,249,242,2440,491
12828,7129,94,659,2393,1549,861,912,661,6376,1573
12831,12668,245,541,3237,2134,1203,3134,2174,11882,5308
12832,4987,164,332,2182,1076,413,472,348,4491,820
12833,3754,31,300,1116,463,301,764,779,3423,1543
12834,4580,232,147,1477,712,563,879,570,4201,1449
12835,2189,57,171,813,386,239,293,230,1961,523
12836,446,5,34,123,124,23,84,53,407,137
12837,650,13,62,164,218,92,72,29,575,101
12838,556,10,4,200,154,92,83,13,542,96
12839,10322,340,746,4851,1666,1132,1058,529,9236,1587
12841,95,0,2,12,17,9,42,13,93,55
12842,582,14,32,271,60,72,95,38,536,133
12843,477,7,11,199,90,76,64,30,459,94
12844,240,0,0,49,9,22,71,89,240,160
12845,3496,42,172,881,657,498,705,541,3282,1246
12846,2565,141,189,702,241,561,303,428,2235,731
12847,531,38,4,153,73,60,119,84,489,203
12849,292,44,1,174,61,0,0,12,247,12
12850,2073,84,66,811,245,287,454,126,1923,580
12851,251,18,20,61,62,42,26,22,213,48
12852,291,15,18,85,53,10,72,38,258,110
12853,1027,45,104,247,219,168,178,66,878,244
12854,49,0,0,49,0,0,0,0,49,0
12855,174,2,25,39,47,28,24,9,147,33
12856,279,10,0,26,27,23,82,111,269,193
12857,635,34,18,187,123,85,78,110,583,188
12858,128,0,7,47,10,0,12,52,121,64
12859,1197,7,122,320,347,132,89,180,1068,269
12860,273,0,12,120,39,50,37,15,261,52
12861,388,10,8,120,108,51,44,47,370,91
12862,206,0,4,53,25,0,124,0,202,124
12863,553,0,8,177,120,69,95,84,545,179
12864,9,0,0,0,0,0,9,0,9,9
12865,2522,89,135,779,463,331,359,366,2298,725
12866,28626,637,996,5835,3480,2063,8026,7589,26993,15615
12870,1313,2,39,357,253,148,242,272,1272,514
12871,3098,29,209,1024,475,402,595,364,2860,959
12872,103,0,0,0,0,53,50,0,103,50
12873,714,11,12,266,83,84,150,108,691,258
12874,115,0,0,2,16,0,43,54,115,97
12878,501,10,42,249,109,39,28,24,449,52
12883,3757,99,248,1514,511,431,486,468,3410,954
12884,386,15,35,244,34,15,28,15,336,43
12885,3229,162,326,1306,616,263,303,253,2741,556
12886,217,0,13,45,11,41,59,48,204,107
12887,3055,332,116,1277,480,443,252,155,2607,407
12901,20866,759,1456,5855,3383,2316,4023,3074,18651,7097
12903,1170,1,15,194,179,229,282,270,1154,552
12910,1365,83,224,643,183,133,46,53,1058,99
12911,0,0,0,0,0,0,0,0,0,0
12912,1367,72,51,436,159,269,223,157,1244,380
12913,709,11,37,177,95,155,86,148,661,234
12914,632,48,93,232,63,137,37,22,491,59
12915,57,0,8,32,17,0,0,0,49,0
12916,1593,13,106,774,207,232,141,120,1474,261
12917,806,61,46,355,94,151,73,26,699,99
12918,1935,20,26,655,216,195,585,238,1889,823
12919,1804,49,143,447,533,264,160,208,1612,368
12920,1673,45,124,587,292,271,223,131,1504,354
12921,2012,23,58,685,290,418,325,213,1931,538
12922,28,2,0,10,0,8,3,5,26,8
12923,364,36,13,156,97,18,5,39,315,44
12924,146,0,70,58,18,0,0,0,76,0
12926,1683,85,133,808,245,208,117,87,1465,204
12927,277,6,5,101,24,73,34,34,266,68
12928,1446,28,37,816,221,183,82,79,1381,161
12929,2951,317,983,1137,219,94,142,59,1651,201
12930,549,20,54,194,88,115,35,43,475,78
12932,909,52,50,278,156,155,129,89,807,218
12933,27,0,27,0,0,0,0,0,0,0
12934,845,19,129,392,78,96,59,72,697,131
12935,1068,50,89,461,153,105,108,102,929,210
12936,527,12,14,136,80,27,132,126,501,258
12937,989,40,22,381,234,176,56,80,927,136
12939,112,5,14,21,19,28,4,21,93,25
12941,1376,22,19,501,179,120,306,229,1335,535
12942,485,0,7,86,41,30,200,121,478,321
12943,248,10,4,87,13,39,49,46,234,95
12944,2698,54,134,988,566,297,409,250,2510,659
12945,378,0,38,69,22,68,69,112,340,181
12946,3433,52,160,847,551,363,853,607,3221,1460
12950,516,4,54,247,106,10,72,23,458,95
12952,171,44,0,84,25,0,12,6,127,18
12953,10074,646,1286,3863,1360,952,1146,821,8142,1967
12955,308,7,0,127,91,17,49,17,301,66
12956,1007,0,210,452,87,120,135,3,797,138
12957,1219,23,221,573,100,7,39,256,975,295
12958,1237,59,63,418,208,216,171,102,1115,273
12959,1114,39,139,393,142,200,154,47,936,201
12960,783,24,11,213,121,61,333,20,748,353
12961,97,0,11,10,0,0,0,76,86,76
12962,3611,34,268,1402,700,339,552,316,3309,868
12964,87,16,9,14,7,0,18,23,62,41
12965,205,7,17,64,49,39,15,14,181,29
12966,1991,151,140,767,330,246,277,80,1700,357
12967,831,15,68,348,162,85,93,60,748,153
12969,200,3,7,76,43,7,34,30,190,64
12970,279,0,0,44,43,38,102,52,279,154
12972,5014,51,287,1485,753,729,809,900,4676,1709
12973,120,0,17,54,21,14,9,5,103,14
12974,1617,16,147,538,224,255,255,182,1454,437
12975,172,0,7,24,61,20,20,40,165,60
12976,152,0,4,36,13,4,31,64,148,95
12977,1211,82,372,610,113,15,6,13,757,19
12978,234,0,36,111,65,22,0,0,198,0
12979,1787,74,173,658,348,171,169,194,1540,363
12980,902,27,92,383,128,138,49,85,783,134
12981,1603,32,134,699,234,178,152,174,1437,326
12983,5380,63,341,1005,1106,692,1130,1043,4976,2173
12985,724,21,110,331,103,37,62,60,593,122
12986,4046,119,291,1252,858,621,563,342,3636,905
12987,120,0,5,4,30,20,39,22,115,61
12989,741,12,39,199,148,146,120,77,690,197
12992,2852,91,231,1077,590,300,348,215,2530,563
12993,1225,32,20,413,174,148,172,266,1173,438
12996,1602,25,84,418,259,370,233,213,1493,446
12997,984,19,20,251,244,108,186,156,945,342
12998,183,11,7,98,67,0,0,0,165,0
13020,79,0,9,31,3,18,9,9,70,18
13021,27621,749,1900,8021,5549,4316,4020,3066,24972,7086
13024,1298,155,717,250,42,128,6,0,426,6
13026,1066,8,44,231,150,222,179,232,1014,411
13027,24703,208,912,5271,4494,3432,5981,4405,23583,10386
13028,580,7,0,158,183,114,68,50,573,118
13029,5487,100,244,1321,685,1359,997,781,5143,1778
13030,2815,20,121,1079,638,181,391,385,2674,776
13031,11642,154,387,2497,2195,1530,2744,2135,11101,4879
13032,9556,269,503,3784,1544,1685,878,893,8784,1771
13033,2387,25,81,990,495,368,259,169,2281,428
13034,1423,37,86,496,260,176,179,189,1300,368
13035,5504,61,154,1031,785,662,1445,1366,5289,2811
13036,6581,116,302,2481,1230,1034,909,509,6163,1418
13037,6715,43,209,2274,1144,903,1078,1064,6463,2142
13039,12053,133,332,2936,2173,2117,2558,1804,11588,4362
13040,1848,31,175,762,328,242,159,151,1642,310
13041,8630,198,415,2127,1169,1554,1982,1185,8017,3167
13042,1481,14,129,534,315,133,258,98,1338,356
13044,2105,13,303,708,335,531,169,46,1789,215
13045,16538,890,803,4511,3379,2006,2642,2307,14845,4949
13051,37,0,0,0,37,0,0,0,37,0
13052,1285,28,43,538,209,180,199,88,1214,287
13053,3049,57,100,684,522,362,708,616,2892,1324
13054,827,0,2,370,139,69,209,38,825,247
13057,10947,178,711,3012,2243,1486,1907,1410,10058,3317
13060,1945,87,139,661,355,398,198,107,1719,305
13061,508,2,17,120,88,106,80,95,489,175
13062,180,1,0,53,0,65,61,0,179,61
13063,1402,14,56,523,105,295,102,307,1332,409
13065,147,0,17,81,34,15,0,0,130,0
13066,9260,57,283,950,1102,763,2631,3474,8920,6105
13068,3526,0,105,882,634,486,734,685,3421,1419
13069,16365,485,1290,6708,2719,2230,1847,1086,14590,2933
13071,577,27,32,219,73,94,85,47,518,132
13072,684,7,56,310,116,97,70,28,621,98
13073,4536,58,181,1783,730,462,739,583,4297,1322
13074,3128,39,252,1601,654,206,301,75,2837,376
13076,1767,78,72,724,451,180,173,89,1617,262
13077,4901,41,230,1453,861,572,978,766,4630,1744
13078,7745,182,370,1509,1029,690,1713,2252,7193,3965
13080,2663,38,164,947,450,379,358,327,2461,685
13081,868,2,32,171,94,124,242,203,834,445
13082,2817,28,77,1110,551,406,465,180,2712,645
13083,1522,35,160,507,310,204,205,101,1327,306
13084,2787,16,77,769,556,464,320,585,2694,905
13087,117,0,0,18,29,19,29,22,117,51
13088,16476,400,866,4366,3128,2336,3383,1997,15210,5380
13090,20080,427,864,4279,3350,2832,4629,3699,18789,8328
13092,1763,34,171,742,344,211,186,75,1558,261
13101,1512,40,85,620,356,178,164,69,1387,233
13102,52,0,0,33,0,0,19,0,52,19
13103,172,6,43,75,30,9,9,0,123,9
13104,11753,268,211,1696,1619,756,3436,3767,11274,7203
13108,4789,33,143,1063,699,771,1174,906,4613,2080
13110,1839,39,60,397,295,209,507,332,1740,839
13111,1103,25,126,459,163,109,126,95,952,221
13112,1178,8,73,568,185,102,107,135,1097,242
13113,44,0,2,17,11,12,2,0,42,2
13114,5284,164,668,1808,992,707,597,348,4452,945
13115,163,6,0,52,32,20,19,34,157,53
13116,2728,63,338,802,465,231,511,318,2327,829
13117,197,5,26,129,12,15,6,4,166,10
13118,4336,246,549,1468,786,595,466,226,3541,692
13119,0,0,0,0,0,0,0,0,0,0
13120,1647,54,110,702,430,113,122,116,1483,238
13121,0,0,0,0,0,0,0,0,0,0
13122,756,0,27,295,120,173,120,21,729,141
13123,32,0,32,0,0,0,0,0,0,0
13124,80,1,1,34,11,13,13,7,78,20
13126,22219,502,1343,7528,3976,2604,3335,2931,20374,6266
13131,2337,118,254,777,405,307,330,146,1965,476
13132,2575,113,42,784,394,455,419,368,2420,787
13134,131,0,0,88,16,7,12,8,131,20
13135,4345,30,333,1490,783,580,559,570,3982,1129
13136,221,0,23,129,21,17,12,19,198,31
13138,116,0,0,37,4,52,23,0,116,23
13140,3141,243,329,1370,559,364,165,111,2569,276
13141,494,6,17,175,86,93,68,49,471,117
13142,4395,160,219,1536,1056,516,574,334,4016,908
13143,1562,31,109,688,261,133,192,148,1422,340
13144,858,16,165,353,131,86,78,29,677,107
13145,1167,9,132,439,125,215,158,89,1026,247
13146,1448,177,85,707,268,96,65,50,1186,115
13147,674,104,57,222,110,89,40,52,513,92
13148,8044,393,866,2584,1282,1074,1139,706,6785,1845
13152,5828,50,136,1011,760,645,1672,1554,5642,3226
13153,183,0,5,99,23,9,0,47,178,47
13154,22,0,0,11,11,0,0,0,22,0
13155,414,10,21,171,82,48,38,44,383,82
13156,1714,83,7,525,374,295,240,190,1624,430
13157,420,0,51,178,41,67,36,47,369,83
13158,1026,26,59,389,206,76,186,84,941,270
13159,3676,31,128,801,605,558,857,696,3517,1553
13160,1498,27,54,362,278,241,272,264,1417,536
13162,239,0,0,152,19,3,52,13,239,65
13163,255,9,17,106,41,31,36,15,229,51
13164,1611,0,54,377,286,202,468,224,1557,692
13165,6957,258,404,2477,1238,1294,831,455,6295,1286
13166,4318,78,231,1603,749,605,702,350,4009,1052
13167,2134,40,238,795,493,185,259,124,1856,383
13202,4808,421,592,1377,500,266,775,877,3795,1652
13203,11848,656,1289,3350,2018,1216,1804,1515,9903,3319
13204,12527,562,1334,4245,2120,1353,1838,1075,10631,2913
13205,11750,637,1397,3778,2267,1148,1444,1079,9716,2523
13206,12275,614,686,3142,2773,1712,2099,1249,10975,3348
13207,8707,194,627,2426,1637,988,1688,1147,7886,2835
13208,14973,1524,2240,4820,2663,1330,1588,808,11209,2396
13209,9943,296,633,3417,1711,1241,1655,990,9014,2645
13210,10192,330,712,1476,1798,633,2231,3012,9150,5243
13211,3943,67,318,1660,735,549,531,83,3558,614
13212,15561,213,756,5002,2961,2318,2805,1506,14592,4311
13214,5279,102,181,1078,658,530,1207,1523,4996,2730
13215,10261,163,286,2146,1411,1327,2552,2376,9812,4928
13219,11295,304,384,2608,1747,1405,2851,1996,10607,4847
13224,6109,264,246,937,818,572,1326,1946,5599,3272
13244,28,0,0,0,0,0,19,9,28,28
13290,0,0,0,0,0,0,0,0,0,0
13301,117,0,0,0,24,11,43,39,117,82
13302,990,90,67,386,189,158,73,27,833,100
13303,1028,20,13,336,295,106,108,150,995,258
13304,1300,27,31,301,193,225,424,99,1242,523
13305,159,0,22,66,50,0,8,13,137,21
13308,3267,135,290,1091,600,518,495,138,2842,633
13309,4335,135,269,1921,609,556,568,277,3931,845
13310,554,0,6,272,47,114,85,30,548,115
13312,272,0,0,82,22,56,50,62,272,112
13313,439,14,74,241,59,35,6,10,351,16
13314,79,0,32,14,15,4,14,0,47,14
13315,959,75,34,363,157,132,89,109,850,198
13316,4361,127,279,1981,547,494,623,310,3955,933
13317,2470,174,157,958,426,350,288,117,2139,405
13318,712,5,37,324,178,47,93,28,670,121
13319,463,0,45,167,141,0,75,35,418,110
13320,1374,44,46,444,181,220,277,162,1284,439
13321,618,22,9,199,31,224,107,26,587,133
13322,811,12,70,275,149,114,105,86,729,191
13323,7407,126,112,1434,820,1112,1752,2051,7169,3803
13324,1324,65,108,467,300,158,129,97,1151,226
13325,679,2,58,326,94,107,30,62,619,92
13326,3700,64,63,834,500,391,841,1007,3573,1848
13327,1468,24,108,727,168,86,217,138,1336,355
13328,1091,42,49,313,130,214,202,141,1000,343
13329,2479,66,166,1081,490,351,178,147,2247,325
13331,69,0,0,5,0,34,7,23,69,30
13332,1790,130,143,541,297,185,211,283,1517,494
13333,44,0,0,14,3,14,0,13,44,13
13334,719,15,14,243,127,248,49,23,690,72
13335,870,65,93,343,127,104,99,39,712,138
13337,547,0,10,76,108,62,98,193,537,291
13338,914,5,88,223,200,151,179,68,821,247
13339,3957,148,257,1522,862,458,378,332,3552,710
13340,5200,218,225,1873,840,926,661,457,4757,1118
13342,141,17,10,41,13,21,24,15,114,39
13343,1184,0,77,596,145,153,109,104,1107,213
13345,122,4,3,70,18,7,9,11,115,20
13346,2914,40,96,791,268,383,486,850,2778,1336
13348,1061,20,60,345,155,137,202,142,981,344
13350,7288,290,418,2601,1490,1097,918,474,6580,1392
13352,5,0,0,0,2,3,0,0,5,0
13353,32,0,2,18,8,0,3,1,30,4
13354,2262,120,57,721,321,442,255,346,2085,601
13355,850,37,142,350,142,71,54,54,671,108
13357,7554,64,456,2389,1519,1269,1138,719,7034,1857
13360,63,0,5,2,15,25,16,0,58,16
13361,464,40,18,117,67,63,85,74,406,159
13363,1625,21,124,606,207,359,199,109,1480,308
13364,205,0,8,76,111,5,5,0,197,5
13365,5318,108,290,1689,1044,1026,649,512,4920,1161
13367,6101,241,356,2315,800,1006,831,552,5504,1383
13368,758,9,39,357,131,90,68,64,710,132
13402,761,2,13,410,100,50,72,114,746,186
13403,4839,224,785,1405,880,563,470,512,3830,982
13404,81,0,7,51,0,9,14,0,74,14
13406,330,1,19,134,48,83,28,17,310,45
13407,3561,57,156,1301,583,699,584,181,3348,765
13408,1517,83,61,507,255,391,140,80,1373,220
13409,1594,12,60,577,372,363,152,58,1522,210
13410,453,11,81,193,70,23,49,26,361,75
13411,2005,47,191,762,366,230,225,184,1767,409
13413,12045,299,280,2463,1724,1377,2992,2910,11466,5902
13415,79,0,0,37,7,9,22,4,79,26
13416,1562,27,109,516,292,339,175,104,1426,279
13417,2579,6,81,501,681,307,510,493,2492,1003
13418,139,4,3,56,24,12,40,0,132,40
13420,1021,156,24,314,43,0,213,271,841,484
13421,9275,174,737,2870,1749,1385,1336,1024,8364,2360
13424,1710,19,117,463,356,269,222,264,1574,486
13425,1337,33,75,521,193,230,155,130,1229,285
13428,1196,15,51,517,158,146,132,177,1130,309
13431,1319,24,69,461,158,265,186,156,1226,342
13433,997,38,65,548,166,58,28,94,894,122
13435,142,0,11,38,54,16,4,19,131,23
13436,83,3,6,23,13,15,7,16,74,23
13437,239,7,22,133,21,24,19,13,210,32
13438,2279,5,120,917,507,229,326,175,2154,501
13439,2572,75,238,811,436,263,467,282,2259,749
13440,29894,1106,2507,9424,6874,3473,3702,2808,26281,6510
13441,154,0,0,0,25,0,52,77,154,129
13450,97,0,9,40,40,4,4,0,88,4
13452,3447,169,402,1256,689,477,229,225,2876,454
13454,610,15,13,263,82,137,59,41,582,100
13455,19,0,0,11,0,0,0,8,19,8
13456,2594,21,55,836,256,494,585,347,2518,932
13457,30,12,0,14,0,2,2,0,18,2
13459,1369,53,85,491,318,126,222,74,1231,296
13460,3010,131,243,1182,533,454,296,171,2636,467
13461,2215,48,36,449,368,469,489,356,2131,845
13464,897,14,94,492,152,78,49,18,789,67
13468,192,0,15,56,31,58,24,8,177,32
13469,860,24,0,54,201,270,130,181,836,311
13470,511,31,76,181,69,83,48,23,404,71
13471,1925,129,172,784,446,195,126,73,1624,199
13472,206,0,0,34,0,56,99,17,206,116
13473,777,7,46,338,141,138,48,59,724,107
13475,36,0,0,17,10,0,0,9,36,9
13476,2082,36,187,902,324,276,248,109,1859,357
13477,912,37,35,450,170,101,72,47,840,119
13478,2186,27,38,698,593,428,274,128,2121,402
13480,2433,72,101,1042,469,276,329,144,2260,473
13482,55,0,0,20,14,16,0,5,55,5
13483,284,0,6,189,28,3,46,12,278,58
13484,29,0,0,29,0,0,0,0,29,0
13485,1005,47,51,398,203,132,108,66,907,174
13486,535,21,45,219,59,50,89,52,469,141
13488,128,0,13,86,2,7,14,6,115,20
13489,335,5,18,140,64,58,18,32,312,50
13490,798,9,0,131,211,162,126,159,789,285
13491,2523,144,154,991,405,272,356,201,2225,557
13492,8170,230,141,2075,1496,940,1937,1351,7799,3288
13493,1358,43,155,647,169,142,112,90,1160,202
13494,172,8,21,65,24,10,17,27,143,44
13495,1443,30,39,435,317,248,216,158,1374,374
13501,25180,3370,2108,7764,4067,2658,2936,2277,19702,5213
13502,22274,1048,1731,6759,4564,2764,3204,2204,19495,5408
13601,25642,820,1677,8325,5225,3118,3604,2873,23145,6477
13602,401,0,0,149,168,42,42,0,401,42
13603,6089,59,41,953,2305,792,1591,348,5989,1939
13605,3449,37,277,1154,554,693,395,339,3135,734
13606,1814,13,202,531,251,260,256,301,1599,557
13607,1473,25,28,470,303,166,312,169,1420,481
13608,1211,29,94,529,230,189,71,69,1088,140
13611,212,0,15,71,22,28,31,45,197,76
13612,2052,12,25,933,455,159,334,134,2015,468
13613,1870,86,113,967,304,162,135,103,1671,238
13614,220,0,8,101,51,21,22,17,212,39
13615,507,2,0,202,126,65,75,37,505,112
13616,1256,226,122,223,317,132,132,104,908,236
13617,6605,240,215,1503,988,1287,1161,1211,6150,2372
13618,1324,18,28,386,269,164,269,190,1278,459
13619,6791,204,581,2730,1165,606,1011,494,6006,1505
13620,1320,69,111,477,193,174,146,150,1140,296
13621,327,0,26,122,51,33,50,45,301,95
13622,1304,28,65,333,318,149,234,177,1211,411
13623,47,0,0,30,15,2,0,0,47,0
13624,3827,141,388,998,720,521,528,531,3298,1059
13625,1192,24,32,415,164,146,236,175,1136,411
13626,1639,41,37,795,273,209,179,105,1561,284
13628,137,0,7,45,25,20,29,11,130,40
13630,917,91,99,332,137,138,56,64,727,120
13632,107,0,0,56,13,38,0,0,107,0
13633,170,32,16,57,14,25,22,4,122,26
13634,2846,85,122,1035,572,401,307,324,2639,631
13635,771,7,81,358,141,96,43,45,683,88
13636,98,1,11,44,15,5,16,6,86,22
13637,2543,9,54,826,714,359,458,123,2480,581
13638,174,0,0,69,77,28,0,0,174,0
13639,24,3,0,5,13,0,0,3,21,3
13640,241,6,0,71,0,32,80,52,235,132
13641,54,0,0,18,16,11,9,0,54,9
13642,6835,277,743,2584,1208,746,786,491,5815,1277
13643,24,0,0,10,0,0,14,0,24,14
13645,0,0,0,0,0,0,0,0,0,0
13646,1517,64,86,493,310,176,207,181,1367,388
13647,76,0,0,22,23,0,0,31,76,31
13648,1432,40,85,550,293,227,149,88,1307,237
13649,30,0,0,14,7,0,9,0,30,9
13650,1026,5,39,272,259,178,149,124,982,273
13651,122,0,0,5,14,15,45,43,122,88
13652,1118,49,44,468,168,135,151,103,1025,254
13654,1435,172,73,367,327,215,171,110,1190,281
13655,2368,40,55,595,546,556,411,165,2273,576
13656,1837,221,172,836,202,198,145,63,1444,208
13658,1800,59,66,565,424,326,214,146,1675,360
13659,267,9,25,117,50,16,37,13,233,50
13660,1212,43,70,485,205,165,128,116,1099,244
13661,1166,10,48,515,247,142,103,101,1108,204
13662,11722,534,618,4598,1981,1268,1482,1241,10570,2723
13664,338,68,13,116,47,30,33,31,257,64
13665,632,12,91,326,102,42,52,7,529,59
13666,125,4,0,79,16,16,4,6,121,10
13667,2282,276,143,961,367,334,93,108,1863,201
13668,2347,101,115,925,371,300,297,238,2131,535
13669,10868,615,1115,3713,2107,1200,1186,932,9138,2118
13670,292,6,60,121,45,44,10,6,226,16
13672,290,9,6,121,64,21,31,38,275,69
13673,1265,9,87,493,313,164,82,117,1169,199
13674,87,0,0,0,9,0,21,57,87,78
13675,33,0,0,0,9,12,12,0,33,12
13676,8248,139,396,2274,1395,931,1277,1836,7713,3113
13678,58,0,0,58,0,0,0,0,58,0
13679,742,6,31,215,150,105,153,82,705,235
13680,772,88,50,247,112,132,55,88,634,143
13681,640,54,83,300,93,70,28,12,503,40
13682,588,12,7,241,109,103,68,48,569,116
13683,27,0,0,0,0,27,0,0,27,0
13684,782,44,53,365,98,107,51,64,685,115
13685,1717,37,19,549,211,133,351,417,1661,768
13687,410,6,29,168,27,58,78,44,375,122
13690,553,29,64,185,76,81,37,81,460,118
13691,2117,15,113,640,597,417,164,171,1989,335
13692,196,0,0,8,49,23,10,106,196,116
13693,278,0,0,87,73,24,79,15,278,94
13694,997,29,47,377,98,124,109,213,921,322
13695,127,0,0,24,15,14,32,42,127,74
13696,174,0,0,118,56,0,0,0,174,0
13697,1515,3,110,615,274,246,122,145,1402,267
13699,11,0,0,11,0,0,0,0,11,0
13730,2266,52,194,1074,526,221,151,48,2020,199
13731,884,10,46,260,180,79,167,142,828,309
13732,5341,41,127,1405,913,920,1067,868,5173,1935
13733,3751,119,351,1593,535,399,458,296,3281,754
13734,1681,25,118,932,311,130,78,87,1538,165
13736,1311,39,86,543,192,179,116,156,1186,272
13738,16,0,9,0,7,0,0,0,7,0
13739,681,25,37,218,117,94,105,85,619,190
13740,433,5,22,96,43,72,113,82,406,195
13743,2471,48,155,957,435,492,248,136,2268,384
13744,825,6,94,272,193,159,88,13,725,101
13746,1651,42,108,783,289,164,168,97,1501,265
13747,29,0,0,0,0,29,0,0,29,0
13748,2781,19,294,900,722,594,116,136,2468,252
13750,547,0,15,209,132,35,111,45,532,156
13751,100,0,0,8,8,23,53,8,100,61
13752,523,11,29,251,41,41,80,70,483,150
13753,3102,52,142,706,516,488,593,605,2908,1198
13754,1962,37,144,813,430,275,148,115,1781,263
13755,723,3,37,403,115,84,52,29,683,81
13756,541,8,51,244,59,29,71,79,482,150
13757,1066,5,89,286,234,122,150,180,972,330
13760,30514,739,1488,8582,5481,4001,5485,4738,28287,10223
13774,130,12,7,92,15,4,0,0,111,0
13775,1396,6,52,515,308,185,143,187,1338,330
13776,295,2,5,100,48,20,60,60,288,120
13777,297,0,17,153,53,20,19,35,280,54
13778,3797,58,153,1422,715,580,341,528,3586,869
13780,561,32,42,231,77,73,78,28,487,106
13782,604,19,79,239,70,62,91,44,506,135
13783,1862,96,172,761,355,160,188,130,1594,318
13784,224,0,102,64,32,12,6,8,122,14
13786,295,5,42,116,30,46,11,45,248,56
13787,2255,79,205,941,510,186,132,202,1971,334
13788,794,13,42,193,126,74,152,194,739,346
13790,12811,565,797,3829,2065,1875,2328,1352,11449,3680
13795,2345,0,90,900,629,445,200,81,2255,281
13796,817,31,26,279,173,74,138,96,760,234
13797,1362,23,160,589,179,178,115,118,1179,233
13801,1128,48,120,492,163,122,115,68,960,183
13802,701,9,10,262,264,12,41,103,682,144
13803,2660,144,229,1005,527,386,175,194,2287,369
13804,115,3,12,65,16,10,7,2,100,9
13806,156,8,0,51,24,36,25,12,148,37
13807,985,12,80,384,67,150,171,121,893,292
13808,896,10,59,277,152,80,136,182,827,318
13809,1270,23,66,575,325,115,90,76,1181,166
13810,955,0,8,295,266,62,188,136,947,324
13811,2873,83,188,908,400,383,608,303,2602,911
13812,1637,67,114,664,287,161,218,126,1456,344
13813,573,0,5,187,120,131,19,111,568,130
13814,11,0,0,8,0,0,0,3,11,3
13815,9346,218,759,3515,1676,988,1147,1043,8369,2190
13820,13026,143,745,3484,2323,1191,2799,2341,12138,5140
13825,2196,36,157,864,330,239,239,331,2003,570
13826,91,0,0,31,47,13,0,0,91,0
13827,8412,151,596,2583,1269,1290,1658,865,7665,2523
13830,3543,134,336,1394,653,545,233,248,3073,481
13832,311,12,46,170,24,24,23,12,253,35
13833,2547,53,313,1139,316,315,224,187,2181,411
13834,118,0,0,71,28,10,9,0,118,9
13835,962,51,83,379,131,110,133,75,828,208
13838,2694,73,182,1070,431,412,296,230,2439,526
13839,927,3,139,443,173,56,41,72,785,113
13841,313,10,46,136,36,15,28,42,257,70
13842,475,4,54,210,69,51,31,56,417,87
13843,1468,33,206,514,194,240,149,132,1229,281
13844,446,17,17,230,86,59,29,8,412,37
13846,314,5,16,151,12,37,64,29,293,93
13847,14,0,0,0,11,3,0,0,14,0
13849,3360,71,269,1379,439,457,412,333,3020,745
13850,15961,397,546,3629,2163,2271,3353,3602,15018,6955
13856,4539,137,254,2156,550,401,517,524,4148,1041
13859,73,0,0,47,10,0,16,0,73,16
13860,171,0,0,60,0,0,18,93,171,111
13861,379,0,42,51,27,32,147,80,337,227
13862,2487,27,112,1002,492,298,271,285,2348,556
13863,354,0,69,151,28,57,35,14,285,49
13864,844,19,0,322,143,164,138,58,825,196
13865,4315,28,292,1619,814,500,558,504,3995,1062
13901,13701,589,1183,4527,2392,1514,1761,1735,11929,3496
13902,30,0,0,0,30,0,0,0,30,0
13903,12793,243,963,3234,2027,1861,2573,1892,11587,4465
13904,6604,344,861,2135,1231,825,757,451,5399,1208
13905,17559,717,986,4628,3106,1822,2995,3305,15856,6300
14001,6750,69,439,1938,1616,843,1165,680,6242,1845
14004,8571,317,575,3314,1400,1196,1100,669,7679,1769
14005,1388,5,84,562,271,134,214,118,1299,332
14006,6922,175,400,2407,1409,911,933,687,6347,1620
14008,1082,41,111,371,189,158,137,75,930,212
14009,3858,47,171,1548,748,565,410,369,3640,779
14011,5871,405,1273,1782,813,693,569,336,4193,905
14012,2154,37,166,866,396,309,261,119,1951,380
14013,1218,29,52,472,215,156,203,91,1137,294
14020,16380,506,830,5637,2969,2739,1945,1754,15044,3699
14024,1073,33,43,450,188,196,98,65,997,163
14025,2953,11,87,1055,404,151,763,482,2855,1245
14026,420,0,36,27,64,74,131,88,384,219
14027,34,0,0,19,9,6,0,0,34,0
14028,1211,10,55,532,239,147,120,108,1146,228
14029,28,0,5,13,0,8,0,2,23,2
14030,1428,57,76,604,220,217,200,54,1295,254
14031,7497,49,74,1451,1329,881,1658,2055,7374,3713
14032,7144,114,165,1056,965,706,1898,2240,6865,4138
14033,1140,14,16,343,131,144,346,146,1110,492
14034,2002,61,192,850,330,221,208,140,1749,348
14035,38,1,0,1,30,0,0,6,37,6
14036,4246,119,95,2106,636,354,681,255,4032,936
14037,762,20,23,375,170,114,44,16,719,60
14039,59,0,2,28,14,12,3,0,57,3
14040,1207,24,114,428,161,274,106,100,1069,206
14041,115,0,13,45,35,10,8,4,102,12
14042,3104,85,329,1130,668,454,255,183,2690,438
14043,18318,359,798,6414,3473,2538,2661,2075,17161,4736
14047,5001,285,180,1956,921,570,679,410,4536,1089
14048,10834,649,716,4047,2045,1353,1157,867,9469,2024
14051,14199,450,220,1813,1683,1105,3984,4944,13529,8928
14052,13829,255,249,3404,1565,1782,3745,2829,13325,6574
14054,938,2,81,366,171,98,111,109,855,220
14055,1116,6,48,433,134,137,176,182,1062,358
14056,135,0,40,0,95,0,0,0,95,0
14057,5600,102,167,1775,816,998,994,748,5331,1742
14058,1490,30,84,447,289,275,209,156,1376,365
14059,6766,50,140,1806,1142,716,1472,1440,6576,2912
14060,293,11,28,120,78,25,24,7,254,31
14061,71,7,0,31,0,19,6,8,64,14
14062,2296,78,174,893,366,431,217,137,2044,354
14063,8207,217,224,2549,1294,738,1362,1823,7766,3185
14065,1050,72,43,540,119,133,82,61,935,143
14066,853,20,71,323,151,116,106,66,762,172
14067,2818,60,141,836,475,389,635,282,2617,917
14068,5580,206,110,983,744,474,1638,1425,5264,3063
14069,485,2,58,146,45,53,102,79,425,181
14070,4015,225,240,1768,660,482,411,229,3550,640
14072,15598,425,237,3272,3110,2013,3367,3174,14936,6541
14075,32676,390,984,7643,5951,5515,7093,5100,31302,12193
14080,2991,44,141,986,670,530,373,247,2806,620
14081,2083,61,110,809,369,212,353,169,1912,522
14082,412,0,43,120,67,17,97,68,369,165
14083,10,0,5,5,0,0,0,0,5,0
14085,5648,112,121,1376,828,629,1560,1022,5415,2582
14086,25721,402,795,6260,4776,3751,5228,4509,24524,9737
14091,1092,0,74,521,103,226,126,42,1018,168
14092,8168,71,324,1787,1686,1157,1683,1460,7773,3143
14094,36002,871,2039,10287,6978,5698,5699,4430,33092,10129
14098,2062,126,154,727,419,193,287,156,1782,443
14101,1356,13,90,568,381,108,120,76,1253,196
14102,1123,0,68,466,81,81,245,182,1055,427
14103,7648,362,882,2382,1577,840,1027,578,6404,1605
14105,3655,45,264,1391,571,548,509,327,3346,836
14108,3670,146,139,1094,818,487,492,494,3385,986
14109,0,0,0,0,0,0,0,0,0,0
14111,2257,17,150,930,395,311,286,168,2090,454
14112,40,0,0,13,0,14,0,13,40,13
14113,505,0,33,201,119,33,49,70,472,119
14120,32883,711,1380,10240,5576,4716,6411,3849,30792,10260
14125,2598,178,257,1104,283,307,317,152,2163,469
14126,325,0,0,152,30,56,37,50,325,87
14127,22651,104,648,4166,2817,3000,5864,6052,21899,11916
14129,938,86,82,296,115,115,129,115,770,244
14130,66,5,0,37,2,15,0,7,61,7
14131,3941,28,261,1675,776,482,384,335,3652,719
14132,4595,127,466,1319,659,856,743,425,4002,1168
14134,54,10,16,5,11,0,12,0,28,12
14135,94,0,5,50,0,34,0,5,89,5
14136,3798,109,178,1183,825,466,702,335,3511,1037
14138,1329,74,112,520,212,129,207,75,1143,282
14139,1255,0,35,373,241,210,276,120,1220,396
14141,5420,135,240,2129,635,713,963,605,5045,1568
14143,733,3,24,264,170,73,90,109,706,199
14145,917,5,9,399,113,158,158,75,903,233
14150,31464,883,950,8900,6543,4421,6164,3603,29631,9767
14166,195,0,0,19,31,14,64,67,195,131
14167,1312,32,44,531,183,317,133,72,1236,205
14168,56,0,25,0,6,14,11,0,31,11
14169,80,8,0,56,16,0,0,0,72,0
14170,1646,38,19,534,145,283,375,252,1589,627
14171,1301,6,47,558,297,164,172,57,1248,229
14172,2309,44,53,773,429,388,278,344,2212,622
14173,117,0,0,96,0,21,0,0,117,0
14174,4212,21,51,1033,1008,527,948,624,4140,1572
14201,8404,729,717,2108,1224,445,1862,1319,6958,3181
14202,2930,133,118,840,398,175,735,531,2679,1266
14203,1873,103,154,393,238,173,481,331,1616,812
14204,5691,358,645,1608,1441,609,698,332,4688,1030
14206,15547,609,1532,5456,3257,1879,1767,1047,13406,2814
14207,15533,1699,1360,5348,2876,1514,1882,854,12474,2736
14208,7096,278,735,1989,1706,772,866,750,6083,1616
14209,6076,180,277,834,1425,637,1360,1363,5619,2723
14210,11324,553,1222,4346,2132,1214,1297,560,9549,1857
14211,14824,1138,1372,5548,2912,1598,1459,797,12314,2256
14212,8479,595,1454,2914,1795,712,614,395,6430,1009
14213,14983,1590,1679,2848,2573,909,3253,2131,11714,5384
14214,13117,281,875,2344,2340,948,2607,3722,11961,6329
14215,25680,1078,2250,7438,6230,3723,3287,1674,22352,4961
14216,18068,334,865,3022,2891,1369,5318,4269,16869,9587
14217,17109,492,502,4038,2957,2108,3958,3054,16115,7012
14218,14781,660,1241,4877,3210,1707,2190,896,12880,3086
14219,8546,104,375,3353,1666,1482,1171,395,8067,1566
14220,17316,350,760,5822,3160,2566,2869,1789,16206,4658
14221,40755,676,901,6209,6194,3770,10861,12144,39178,23005
14222,10930,69,164,1536,1585,678,3089,3809,10697,6898
14223,17104,180,388,3277,3797,1970,4405,3087,16536,7492
14224,30400,624,972,8718,5576,4693,6267,3550,28804,9817
14225,25047,620,1343,8639,4528,2892,4634,2391,23084,7025
14226,20080,470,424,2765,2875,2027,5844,5675,19186,11519
14227,16455,245,649,6012,3695,2028,2512,1314,15561,3826
14228,16159,644,779,2640,2095,1835,4253,3913,14736,8166
14260,1,0,0,0,0,0,0,1,1,1
14261,71,0,0,0,8,0,22,41,71,63
14301,8983,420,1108,3302,1585,989,847,732,7455,1579
14302,206,25,18,134,0,0,29,0,163,29
14303,3858,371,450,1495,610,399,369,164,3037,533
14304,21485,268,1292,7274,4136,3118,3263,2134,19925,5397
14305,10866,334,757,3897,2102,1286,1485,1005,9775,2490
14411,9683,571,1055,4424,1427,1169,582,455,8057,1037
14413,133,32,24,51,0,0,26,0,77,26
14414,4921,99,77,1359,765,771,992,858,4745,1850
14415,75,5,0,43,15,12,0,0,70,0
14416,2628,28,83,953,476,300,446,342,2517,788
14418,854,117,41,244,164,40,186,62,696,248
14420,11763,270,491,3516,1559,1577,2545,1805,11002,4350
14422,1270,21,52,477,223,207,202,88,1197,290
14423,3486,71,136,1036,685,451,615,492,3279,1107
14424,21261,505,678,5261,3351,2867,4429,4170,20078,8599
14425,9051,143,227,1959,1724,1229,2149,1620,8681,3769
14427,1304,18,51,599,191,246,136,63,1235,199
14428,5292,91,380,1560,875,557,959,870,4821,1829
14432,3628,65,144,1166,665,604,527,457,3419,984
14433,2686,304,241,1057,427,224,261,172,2141,433
14435,1853,33,105,531,313,283,360,228,1715,588
14437,6518,158,402,2512,1325,786,748,587,5958,1335
14441,293,15,21,126,65,20,25,21,257,46
14445,5543,61,455,1454,923,720,1351,579,5027,1930
14450,31638,399,743,4232,3939,3814,9784,8727,30496,18511
14453,0,0,0,0,0,0,0,0,0,0
14454,4789,150,130,903,779,473,1016,1338,4509,2354
14456,12655,588,578,3404,2195,1660,2231,1999,11489,4230
14462,534,24,10,168,91,112,98,31,500,129
14463,221,0,0,91,65,48,12,5,221,17
14464,4836,137,243,1310,982,905,763,496,4456,1259
14466,1372,10,39,408,259,232,257,167,1323,424
14467,7726,254,251,1612,1068,1216,2075,1250,7221,3325
14468,12845,105,450,4128,2128,1629,2851,1554,12290,4405
14469,4555,51,247,1536,827,653,837,404,4257,1241
14470,5536,38,357,2186,1091,756,766,342,5141,1108
14471,2265,52,161,592,582,243,431,204,2052,635
14472,6377,31,103,845,565,794,1884,2155,6243,4039
14475,237,0,6,79,23,0,75,54,231,129
14476,1706,8,55,689,299,253,264,138,1643,402
14477,1268,69,65,479,170,104,284,97,1134,381
14478,504,0,25,47,93,67,194,78,479,272
14479,87,0,17,56,14,0,0,0,70,0
14480,403,5,0,106,135,40,110,7,398,117
14481,1308,64,65,482,169,183,207,138,1179,345
14482,5967,117,169,2047,902,1122,967,643,5681,1610
14485,2755,41,156,592,540,435,569,422,2558,991
14486,184,0,11,71,13,26,24,39,173,63
14487,4162,11,111,1135,873,728,692,612,4040,1304
14489,4964,368,429,1764,986,677,503,237,4167,740
14502,7060,251,210,1543,1119,1006,1738,1193,6599,2931
14504,1112,15,40,371,236,157,206,87,1057,293
14505,3561,141,108,1230,849,571,441,221,3312,662
14506,589,0,0,79,125,20,212,153,589,365
14507,841,35,15,387,164,84,104,52,791,156
14510,3509,78,234,1385,561,603,360,288,3197,648
14511,219,0,18,100,16,0,58,27,201,85
14512,3489,39,126,1225,520,571,461,547,3324,1008
14513,9958,409,844,3319,2286,1209,1105,786,8705,1891
14514,4294,36,177,1143,643,600,868,827,4081,1695
14515,138,0,0,64,0,49,25,0,138,25
14516,1467,126,55,511,357,143,159,116,1286,275
14517,2042,25,200,826,419,172,272,128,1817,400
14519,9000,116,328,2405,1479,1543,2067,1062,8556,3129
14521,2372,177,432,746,314,205,332,166,1763,498
14522,7197,297,455,2244,1410,950,1193,648,6445,1841
14525,1791,24,49,700,323,212,268,215,1718,483
14526,14043,211,267,1821,1750,1425,4687,3882,13565,8569
14527,9143,1177,346,3268,1114,939,1276,1023,7620,2299
14529,48,0,10,12,7,12,0,7,38,7
14530,4359,143,505,1778,761,464,397,311,3711,708
14532,2652,198,52,777,568,451,312,294,2402,606
14533,1341,111,85,460,201,172,114,198,1145,312
14534,24109,227,284,2065,2401,1717,6900,10515,23598,17415
14536,492,1,82,198,51,80,64,16,409,80
14537,81,0,0,39,12,0,30,0,81,30
14539,109,0,0,52,38,0,19,0,109,19
14541,2530,207,708,652,308,237,251,167,1615,418
14542,0,0,0,0,0,0,0,0,0,0
14543,2541,31,27,615,394,419,591,464,2483,1055
14544,1450,101,73,521,294,212,114,135,1276,249
14545,90,0,9,39,18,5,12,7,81,19
14546,3840,25,46,954,807,501,1086,421,3769,1507
14548,3085,118,224,1109,749,408,336,141,2743,477
14549,303,0,0,171,31,36,55,10,303,65
14550,855,27,61,341,126,160,91,49,767,140
14551,4004,121,222,1477,1214,267,443,260,3661,703
14555,1003,3,39,322,190,155,207,87,961,294
14556,1105,75,344,484,114,38,35,15,686,50
14557,96,0,5,36,29,11,9,6,91,15
14559,13174,196,484,3550,2365,1630,2782,2167,12494,4949
14560,1621,42,137,494,247,268,271,162,1442,433
14561,1824,95,111,635,320,344,251,68,1618,319
14564,11435,97,293,1641,1451,1338,3107,3508,11045,6615
14568,4509,75,94,1185,1065,805,791,494,4340,1285
14569,5003,179,222,1912,1182,621,500,387,4602,887
14571,1087,13,206,351,219,65,197,36,868,233
14572,3256,198,178,1306,509,506,293,266,2880,559
14580,40624,598,1271,8291,6321,5981,10058,8104,38755,18162
14585,152,12,30,41,31,22,10,6,110,16
14586,8384,304,254,1219,1397,1292,2342,1576,7826,3918
14588,0,0,0,0,0,0,0,0,0,0
14589,5452,48,333,1566,1032,849,1003,621,5071,1624
14590,3739,149,452,1515,563,471,267,322,3138,589
14591,1205,85,66,413,189,228,149,75,1054,224
14592,103,0,0,28,25,16,25,9,103,34
14604,2175,24,103,272,288,173,664,651,2048,1315
14605,6397,843,1139,2137,1217,351,542,168,4415,710
14606,19097,1321,1867,6028,3371,2162,2982,1366,15909,4348
14607,13257,400,355,1796,1853,1012,3979,3862,12502,7841
14608,8357,486,985,2474,1432,923,1183,874,6886,2057
14609,29086,915,2722,7634,5494,3111,5968,3242,25449,9210
14610,11111,120,268,1311,1451,1007,3440,3514,10723,6954
14611,10595,720,1510,3471,2232,1351,882,429,8365,1311
14612,26127,719,1367,6698,4463,3643,5689,3548,24041,9237
14613,8411,753,1287,2892,1367,638,828,646,6371,1474
14614,941,76,314,279,100,44,100,28,551,128
14615,11986,667,724,3771,2592,1745,1664,823,10595,2487
14616,18346,525,1087,5999,3555,2834,3128,1218,16734,4346
14617,16223,150,446,2798,3173,2242,4022,3392,15627,7414
14618,15171,211,136,883,1167,945,5194,6635,14824,11829
14619,9424,246,729,2793,1845,1189,1330,1292,8449,2622
14620,18161,493,855,2420,2668,1723,4887,5115,16813,10002
14621,21022,2027,3540,7503,3561,2064,1516,811,15455,2327
14622,9759,444,541,2652,1678,1293,1756,1395,8774,3151
14623,13527,685,689,2690,2012,1891,3149,2411,12153,5560
14624,28261,633,843,7206,5862,4177,5737,3803,26785,9540
14625,8161,77,130,1377,1072,834,2273,2398,7954,4671
14626,22088,1328,1029,6474,3576,2723,4054,2904,19731,6958
14627,16,0,0,6,0,10,0,0,16,0
14642,0,0,0,0,0,0,0,0,0,0
14701,27268,728,2186,8829,4671,4552,3765,2537,24354,6302
14706,4274,108,152,1334,611,566,716,787,4014,1503
14707,72,3,0,30,30,3,6,0,69,6
14708,125,12,0,25,47,34,2,5,113,7
14709,889,33,59,313,151,144,97,92,797,189
14710,2154,41,118,710,344,359,331,251,1995,582
14711,1254,142,72,475,195,130,95,145,1040,240
14712,2433,12,29,805,575,270,318,424,2392,742
14714,356,73,13,159,22,23,37,29,270,66
14715,1867,88,161,620,385,307,193,113,1618,306
14716,1827,67,360,766,193,140,170,131,1400,301
14717,488,8,35,135,86,71,87,66,445,153
14718,1354,2,100,528,239,180,160,145,1252,305
14719,2414,139,157,1004,441,281,206,186,2118,392
14720,603,18,85,253,95,79,27,46,500,73
14721,139,8,23,54,6,31,11,6,108,17
14722,97,3,0,2,3,0,23,66,94,89
14723,770,26,72,328,115,105,65,59,672,124
14724,1570,360,78,434,192,208,185,113,1132,298
14726,1185,410,38,340,143,126,85,43,737,128
14727,3553,114,160,1416,639,517,325,382,3279,707
14728,734,7,55,209,138,76,195,54,672,249
14729,546,12,31,263,69,75,55,41,503,96
14731,997,24,33,368,116,90,180,186,940,366
14732,13,4,0,4,5,0,0,0,9,0
14733,2342,10,150,829,561,400,242,150,2182,392
14735,1726,108,63,657,279,191,243,185,1555,428
14736,143,0,0,50,48,13,6,26,143,32
14737,2958,70,228,1431,547,271,230,181,2660,411
14738,2672,10,262,875,636,430,167,292,2400,459
14739,1832,73,116,805,374,274,133,57,1643,190
14740,826,41,39,287,159,140,114,46,746,160
14741,1296,29,69,486,253,157,158,144,1198,302
14742,90,0,0,10,17,23,9,31,90,40
14743,1504,15,88,802,239,181,110,69,1401,179
14744,916,48,64,134,72,56,245,297,804,542
14747,1448,66,97,693,218,213,98,63,1285,161
14748,375,5,35,158,67,65,17,28,335,45
14750,3366,57,18,726,792,592,600,581,3291,1181
14752,166,26,22,8,15,0,9,86,118,95
14753,701,30,27,374,111,52,53,54,644,107
14754,391,13,20,116,93,77,52,20,358,72
14755,2083,128,115,918,297,315,159,151,1840,310
14756,0,0,0,0,0,0,0,0,0,0
14757,2273,60,123,677,365,318,421,309,2090,730
14760,12512,430,825,4690,1920,1480,1598,1569,11257,3167
14767,1469,349,60,449,173,264,80,94,1060,174
14769,489,14,49,150,92,79,74,31,426,105
14770,1966,43,97,722,291,323,272,218,1826,490
14772,2796,196,145,997,481,346,311,320,2455,631
14774,178,43,6,38,60,27,4,0,129,4
14775,1622,57,124,724,245,166,141,165,1441,306
14777,363,25,48,98,85,52,44,11,290,55
14778,10,0,0,2,0,2,2,4,10,6
14779,4766,132,422,2094,913,542,456,207,4212,663
14781,1322,91,80,516,214,212,92,117,1151,209
14782,1723,67,87,700,268,220,271,110,1569,381
14783,102,4,17,36,4,15,8,18,81,26
14784,616,39,67,188,121,67,66,68,510,134
14785,130,0,0,82,0,0,48,0,130,48
14787,3633,66,325,1227,511,410,703,391,3242,1094
14788,99,16,2,0,52,0,29,0,81,29
14801,3413,241,316,1390,550,434,290,192,2856,482
14802,678,16,14,44,97,41,147,319,648,466
14803,1059,0,47,295,124,121,162,310,1012,472
14804,983,38,24,282,148,193,110,188,921,298
14805,623,7,57,190,143,72,134,20,559,154
14806,1539,31,63,633,279,202,248,83,1445,331
14807,2036,45,117,763,353,289,291,178,1874,469
14808,391,8,0,177,84,62,47,13,383,60
14809,1865,151,165,606,346,251,230,116,1549,346
14810,8940,250,857,3947,1299,1106,816,665,7833,1481
14812,2338,51,138,958,443,445,186,117,2149,303
14813,1549,33,68,605,307,196,169,171,1448,340
14814,1227,15,57,215,131,164,304,341,1155,645
14815,552,3,16,211,114,94,62,52,533,114
14816,484,0,8,169,141,62,38,66,476,104
14817,1954,7,57,341,272,121,475,681,1890,1156
14818,1504,28,44,388,323,193,299,229,1432,528
14819,405,30,23,225,39,46,15,27,352,42
14820,388,15,15,166,70,69,34,19,358,53
14821,2265,21,134,932,395,352,258,173,2110,431
14822,634,9,24,275,109,108,61,48,601,109
14823,2738,162,120,1185,389,279,300,303,2456,603
14824,503,14,36,237,75,59,40,42,453,82
14825,499,17,30,194,121,24,66,47,452,113
14826,1341,55,95,499,230,244,115,103,1191,218
14827,16,0,0,16,0,0,0,0,16,0
14830,13557,223,345,3214,2016,2018,2711,3030,12989,5741
14836,695,19,48,332,96,67,52,81,628,133
14837,3753,319,187,1411,660,388,465,323,3247,788
14838,1501,15,115,610,283,229,145,104,1371,249
14839,438,0,30,158,98,35,33,84,408,117
14840,2168,34,79,517,335,372,451,380,2055,831
14841,584,0,55,73,145,40,159,112,529,271
14842,515,158,0,111,107,37,99,3,357,102
14843,9188,213,495,3549,1911,1150,928,942,8480,1870
14845,15101,225,432,4697,2592,2354,2808,1993,14444,4801
14846,600,15,40,274,79,97,40,55,545,95
14847,1669,94,41,492,265,206,322,249,1534,571
14850,36430,693,730,3883,3501,2232,9903,15488,35007,25391
14853,23,0,0,0,10,0,9,4,23,13
14854,95,21,0,0,31,0,9,34,74,43
14855,491,21,14,184,119,85,26,42,456,68
14856,0,0,0,0,0,0,0,0,0,0
14858,989,24,48,391,173,153,122,78,917,200
14859,773,56,72,305,136,49,67,88,645,155
14860,841,45,32,398,141,55,94,76,764,170
14861,933,12,138,407,197,60,93,26,783,119
14864,742,2,80,260,69,99,102,130,660,232
14865,1938,19,147,747,434,228,221,142,1772,363
14867,3882,39,221,1354,718,422,674,454,3622,1128
14869,1061,12,87,528,135,110,91,98,962,189
14870,7025,86,316,1595,1120,1176,1032,1700,6623,2732
14871,3385,79,257,1252,705,417,303,372,3049,675
14872,416,7,13,72,209,30,16,69,396,85
14873,1390,73,63,569,252,160,166,107,1254,273
14874,92,3,0,24,9,16,11,29,89,40
14877,423,7,39,197,70,41,45,24,377,69
14878,503,73,39,213,55,39,32,52,391,84
14879,1661,79,81,687,298,250,174,92,1501,266
14880,1158,18,33,428,310,144,139,86,1107,225
14881,228,0,0,17,48,39,75,49,228,124
14882,2625,0,64,418,314,525,579,725,2561,1304
14883,3041,71,189,1049,555,337,492,348,2781,840
14884,194,2,13,66,33,36,25,19,179,44
14885,394,28,16,172,68,65,23,22,350,45
14886,4877,47,70,1062,887,607,1092,1112,4760,2204
14889,887,33,29,314,184,125,129,73,825,202
14891,3370,132,163,1087,783,385,420,400,3075,820
14892,5533,148,320,2574,897,698,549,347,5065,896
14893,13,0,0,6,0,7,0,0,13,0
14894,1078,32,106,642,98,111,68,21,940,89
14895,6688,96,316,1995,1354,1146,1005,776,6276,1781
14897,511,15,59,243,75,81,16,22,437,38
14898,928,61,70,381,163,114,54,85,797,139
14901,9854,510,1622,3755,1564,966,878,559,7722,1437
14903,5019,112,151,1412,1344,713,832,455,4756,1287
14904,9910,287,879,3966,1741,1404,762,871,8744,1633
14905,6322,116,255,1524,1238,740,1175,1274,5951,2449
